pd_affinity_status	gauge
pd_api_bench_pd_api_execution_duration_seconds	histogram
pd_api_bench_pd_api_request_total	counter
pd_balance_range_job	gauge
pd_balance_range_store	gauge
pd_checker_check_region_duration_seconds	histogram
pd_checker_event_count	counter
pd_checker_patrol_phase_duration_seconds	histogram
pd_checker_patrol_region_channel_size	gauge
pd_checker_patrol_regions_time	gauge
pd_checker_region_list	gauge
pd_client_cmd_handle_cmds_duration_seconds	histogram
pd_client_cmd_handle_failed_cmds_duration_seconds	histogram
pd_client_internal_cmd_handle_cmds_duration_seconds	histogram
pd_client_internal_cmd_handle_failed_cmds_duration_seconds	histogram
pd_client_request_circuit_breaker_count	counter
pd_client_request_estimate_tso_latency	gauge
pd_client_request_forwarded_status	gauge
pd_client_request_handle_query_region_batch_size	histogram
pd_client_request_handle_query_region_best_batch_size	histogram
pd_client_request_handle_requests_duration_seconds	histogram
pd_client_request_handle_tso_batch_size	histogram
pd_client_request_handle_tso_best_batch_size	histogram
pd_client_request_ongoing_requests_count	gauge
pd_client_request_query_region_batch_send_latency	histogram
pd_client_request_tso_batch_send_latency	histogram
pd_client_request_tso_retry	histogram
pd_cluster_bucket_event	counter
pd_cluster_eta	gauge
pd_cluster_health_status	gauge
pd_cluster_id	gauge
pd_cluster_metadata	gauge
pd_cluster_placement_status	gauge
pd_cluster_progress	gauge
pd_cluster_region_event	counter
pd_cluster_speed	gauge
pd_cluster_status	gauge
pd_cluster_store_limit	gauge
pd_cluster_store_sync	counter
pd_cluster_store_trigger_network_slow_evict	counter
pd_cluster_update_stores_stats_time	gauge
pd_config_status	gauge
pd_core_acquire_regions_lock_wait_duration_seconds_count	counter
pd_core_acquire_regions_lock_wait_duration_seconds_sum	counter
pd_core_query_region_count	counter
pd_core_query_region_duration_seconds	histogram
pd_core_region_heartbeat_breakdown_handle_duration_seconds_count	counter
pd_core_region_heartbeat_breakdown_handle_duration_seconds_sum	counter
pd_gc_gc_safepoint	gauge
pd_hbstream_region_message	counter
pd_hotcache_status	gauge
pd_hotspot_status	gauge
pd_maintenance_task_info	gauge
pd_monitor_time_jump_back_total	counter
pd_ratelimit_runner_failed_tasks_total	counter
pd_ratelimit_runner_pending_tasks	gauge
pd_ratelimit_runner_success_tasks_total	counter
pd_ratelimit_runner_task_execution_duration_seconds	histogram
pd_ratelimit_runner_task_max_waiting_duration_seconds	gauge
pd_region_syncer_status	gauge
pd_regions_abnormal_peer_duration_seconds	histogram
pd_regions_label_level	gauge
pd_regions_status	gauge
pd_replication_dr_recover_progress	gauge
pd_replication_dr_recovered_region	gauge
pd_replication_dr_state	gauge
pd_replication_dr_state_id	gauge
pd_replication_dr_tick_total	counter
pd_rule_manager_status	gauge
pd_schedule_finish_operator_steps_duration_seconds	histogram
pd_schedule_finish_operators_duration_seconds	histogram
pd_schedule_labeler_event_counter	counter
pd_schedule_operator_exceeded_store_limit	counter
pd_schedule_operator_limit	counter
pd_schedule_operator_region_size	histogram
pd_schedule_operators_count	gauge
pd_schedule_scatter_distribution	counter
pd_schedule_scatter_operators_count	counter
pd_schedule_scheduling_count	counter
pd_schedule_snapshot_count	counter
pd_schedule_source_filter	counter
pd_schedule_target_filter	counter
pd_scheduler_balance_direction	counter
pd_scheduler_balance_witness	counter
pd_scheduler_bucket_task_duration	histogram
pd_scheduler_event_count	counter
pd_scheduler_evicted_slow_store_status	gauge
pd_scheduler_evicted_stopping_store_status	gauge
pd_scheduler_handle_region_heartbeat_duration_seconds	histogram
pd_scheduler_handle_store_heartbeat_duration_seconds	histogram
pd_scheduler_hot_peer	histogram
pd_scheduler_hot_peers_summary	gauge
pd_scheduler_hot_pending_sum	gauge
pd_scheduler_hot_region	counter
pd_scheduler_hot_region_direction	counter
pd_scheduler_op_influence	gauge
pd_scheduler_region_heartbeat	counter
pd_scheduler_region_heartbeat_latency_seconds	histogram
pd_scheduler_slow_store_trigger_limit	gauge
pd_scheduler_status	gauge
pd_scheduler_store_slow_trend_action_status	gauge
pd_scheduler_store_slow_trend_evicted_status	gauge
pd_scheduler_store_slow_trend_misc	gauge
pd_scheduler_store_status	gauge
pd_scheduler_tolerant_resource	gauge
pd_scheduling_allowance_status	gauge
pd_server_api_concurrency	gauge
pd_server_bucket_report	counter
pd_server_bucket_report_interval_seconds	histogram
pd_server_cluster_state_cpu_usage	gauge
pd_server_cluster_state_current	gauge
pd_server_etcd_client	gauge
pd_server_etcd_endpoint_latency_seconds	histogram
pd_server_etcd_state	gauge
pd_server_forward_fail_total	counter
pd_server_forward_tso_duration_seconds	histogram
pd_server_handle_bucket_report_duration_seconds	histogram
pd_server_handle_tso_batch_size	histogram
pd_server_handle_tso_duration_seconds	histogram
pd_server_handle_tso_proxy_batch_size	histogram
pd_server_handle_tso_proxy_duration_seconds	histogram
pd_server_info	gauge
pd_server_query_region_duration_seconds	histogram
pd_server_region_request_cnt	counter
pd_server_tso_proxy_forward_timeout_total	counter
pd_service_audit_handling_seconds	histogram
pd_service_audit_requests_total	counter
pd_service_maxprocs	gauge
pd_service_memory_quota_bytes	gauge
pd_txn_handle_txns_duration_seconds	histogram
pd_txn_txns_count	counter
service_member_role	gauge
tikv_raftstore_snapshot_duration_seconds	histogram
