pd_affinity_status	gauge	Status of affinity groups scheduling
pd_api_bench_pd_api_execution_duration_seconds	histogram	Duration of PD API execution in benchmark
pd_api_bench_pd_api_request_total	counter	Counter of PD API requests in benchmark
pd_balance_range_job	gauge	Balance range job status
pd_balance_range_store	gauge	Balance range store status by type
pd_checker_check_region_duration_seconds	histogram	Duration of checking regions in checkers
pd_checker_event_count	counter	Counter of checker events by type and name
pd_checker_patrol_phase_duration_seconds	histogram	Duration of patrol check phases
pd_checker_patrol_region_channel_size	gauge	Size of patrol region channel
pd_checker_patrol_regions_time	gauge	Time spent on patrol checking regions
pd_checker_region_list	gauge	Number of regions by type in checker list
pd_client_cmd_handle_cmds_duration_seconds	histogram	Duration of handling PD client commands
pd_client_cmd_handle_failed_cmds_duration_seconds	histogram	Duration of handling failed PD client commands
pd_client_internal_cmd_handle_cmds_duration_seconds	histogram	Duration of handling internal PD commands
pd_client_internal_cmd_handle_failed_cmds_duration_seconds	histogram	Duration of handling failed internal PD commands
pd_client_request_circuit_breaker_count	counter	Counter of circuit breaker events for PD requests
pd_client_request_estimate_tso_latency	gauge	Estimated TSO latency in milliseconds
pd_client_request_forwarded_status	gauge	Status of PD request forwarding (0=normal, 1=forwarded)
pd_client_request_handle_query_region_batch_size	histogram	Batch size of handling query region requests
pd_client_request_handle_query_region_best_batch_size	histogram	Best batch size for query region requests
pd_client_request_handle_requests_duration_seconds	histogram	Duration of handling PD client requests
pd_client_request_handle_tso_batch_size	histogram	Batch size of handling TSO requests
pd_client_request_handle_tso_best_batch_size	histogram	Best batch size for TSO requests
pd_client_request_ongoing_requests_count	gauge	Number of ongoing PD client requests
pd_client_request_query_region_batch_send_latency	histogram	Latency of sending query region batches
pd_client_request_tso_batch_send_latency	histogram	Latency of sending TSO batches
pd_client_request_tso_retry	histogram	Counter of TSO request retries
pd_cluster_bucket_event	counter	Counter of cluster bucket events by type
pd_cluster_eta	gauge	Estimated time of arrival for cluster operations
pd_cluster_health_status	gauge	Health status of the cluster
pd_cluster_id	gauge	Cluster ID information
pd_cluster_metadata	gauge	Cluster metadata information
pd_cluster_placement_status	gauge	Status of cluster placement rules by type
pd_cluster_progress	gauge	Progress of cluster operations (0-100)
pd_cluster_region_event	counter	Counter of cluster region events by type
pd_cluster_speed	gauge	Speed of cluster operations
pd_cluster_status	gauge	Status of the cluster by type and engine
pd_cluster_store_limit	gauge	Current store limit values by store and type
pd_cluster_store_sync	counter	Counter of store sync operations
pd_cluster_store_trigger_network_slow_evict	counter	Counter of triggering network slow evictions
pd_cluster_update_stores_stats_time	gauge	Time spent updating stores statistics
pd_config_status	gauge	Status of scheduling configurations by type
pd_core_acquire_regions_lock_wait_duration_seconds_count	counter	Wait duration for acquiring regions lock
pd_core_acquire_regions_lock_wait_duration_seconds_sum	counter	Wait duration for acquiring regions lock
pd_core_query_region_count	counter	Counter of query region requests
pd_core_query_region_duration_seconds	histogram	Duration of query region operations
pd_core_region_heartbeat_breakdown_handle_duration_seconds_count	counter	Duration breakdown of handling region heartbeats
pd_core_region_heartbeat_breakdown_handle_duration_seconds_sum	counter	Duration breakdown of handling region heartbeats
pd_gc_gc_safepoint	gauge	Current GC safe point timestamp
pd_hbstream_region_message	counter	Counter of region heartbeat messages by type
pd_hotcache_status	gauge	Status of hot cache by name, store and type
pd_hotspot_status	gauge	Status of hotspot by address, store and type
pd_maintenance_task_info	gauge	Information about maintenance tasks
pd_monitor_time_jump_back_total	counter	Counter of detected time jumps backward
pd_ratelimit_runner_failed_tasks_total	counter	Counter of failed rate limit tasks
pd_ratelimit_runner_pending_tasks	gauge	Number of pending rate limit tasks
pd_ratelimit_runner_success_tasks_total	counter	Counter of successful rate limit tasks
pd_ratelimit_runner_task_execution_duration_seconds	histogram	Duration of rate limit task execution
pd_ratelimit_runner_task_max_waiting_duration_seconds	gauge	Maximum waiting duration for rate limit tasks
pd_region_syncer_status	gauge	Status of region syncer
pd_regions_abnormal_peer_duration_seconds	histogram	Duration of abnormal peer states (miss-voter/down-peer)
pd_regions_label_level	gauge	Number of regions at different label levels
pd_regions_status	gauge	Status of regions by type
pd_replication_dr_recover_progress	gauge	Progress of DR recovery (0-100)
pd_replication_dr_recovered_region	gauge	Number of recovered regions for DR
pd_replication_dr_state	gauge	Current DR state (0=sync, 1=async, 2=recovering)
pd_replication_dr_state_id	gauge	DR state ID
pd_replication_dr_tick_total	counter	Counter of DR tick operations
pd_rule_manager_status	gauge	Status of placement rule manager by type
pd_schedule_finish_operator_steps_duration_seconds	histogram	Duration of finishing operator steps
pd_schedule_finish_operators_duration_seconds	histogram	Duration of finishing operators
pd_schedule_labeler_event_counter	counter	Counter of region labeler events
pd_schedule_operator_exceeded_store_limit	counter	Counter of operators exceeding store limit
pd_schedule_operator_limit	counter	Counter of operators meeting limit by type and name
pd_schedule_operator_region_size	histogram	Size of regions in operators
pd_schedule_operators_count	gauge	Number of operators by status
pd_schedule_scatter_distribution	counter	Distribution of scatter operations
pd_schedule_scatter_operators_count	counter	Counter of scatter operators
pd_schedule_scheduling_count	counter	Counter of scheduling operations
pd_schedule_snapshot_count	counter	Counter of snapshot operations
pd_schedule_source_filter	counter	Counter of source filter applications by type and reason
pd_schedule_target_filter	counter	Counter of target filter applications by type and reason
pd_scheduler_balance_direction	counter	Counter of balance operations by direction (source/target)
pd_scheduler_balance_witness	counter	Counter of balance witness operations by type and store
pd_scheduler_bucket_task_duration	histogram	Duration of bucket scheduling tasks
pd_scheduler_event_count	counter	Counter of scheduler events by type and scheduler
pd_scheduler_evicted_slow_store_status	gauge	Eviction status of slow stores by store and slow type
pd_scheduler_evicted_stopping_store_status	gauge	Eviction status of stopping stores
pd_scheduler_handle_region_heartbeat_duration_seconds	histogram	Duration of handling region heartbeats
pd_scheduler_handle_store_heartbeat_duration_seconds	histogram	Duration of handling store heartbeats
pd_scheduler_hot_peer	histogram	Hot peer statistics distribution
pd_scheduler_hot_peers_summary	gauge	Summary of hot peers by type and store
pd_scheduler_hot_pending_sum	gauge	Pending influence sum in hot region scheduler
pd_scheduler_hot_region	counter	Counter of hot region scheduling by type and store
pd_scheduler_hot_region_direction	counter	Counter of hot region scheduling by direction
pd_scheduler_op_influence	gauge	Operator influence status on stores by scheduler
pd_scheduler_region_heartbeat	counter	Counter of region heartbeats by status
pd_scheduler_region_heartbeat_latency_seconds	histogram	Latency of region heartbeat processing
pd_scheduler_slow_store_trigger_limit	gauge	Trigger limit for slow stores
pd_scheduler_status	gauge	Status of schedulers by kind and type
pd_scheduler_store_slow_trend_action_status	gauge	Slow trend action status for stores
pd_scheduler_store_slow_trend_evicted_status	gauge	Eviction status due to slow trend
pd_scheduler_store_slow_trend_misc	gauge	Miscellaneous slow trend internal values
pd_scheduler_store_status	gauge	Store status for scheduling by address, store and type
pd_scheduler_tolerant_resource	gauge	Tolerant resource values by scheduler
pd_scheduling_allowance_status	gauge	Status of scheduling allowance
pd_server_api_concurrency	gauge	Current API concurrency limit
pd_server_bucket_report	counter	Counter of bucket reports by status
pd_server_bucket_report_interval_seconds	histogram	Interval between bucket reports
pd_server_cluster_state_cpu_usage	gauge	CPU usage of cluster state
pd_server_cluster_state_current	gauge	Current cluster state (0=normal, 1=loading)
pd_server_etcd_client	gauge	etcd client connection status
pd_server_etcd_endpoint_latency_seconds	histogram	Latency of etcd endpoint operations
pd_server_etcd_state	gauge	etcd connection state (0=disconnected, 1=connected)
pd_server_forward_fail_total	counter	Counter of forwarded request failures
pd_server_forward_tso_duration_seconds	histogram	Duration of forwarding TSO requests
pd_server_handle_bucket_report_duration_seconds	histogram	Duration of handling bucket reports
pd_server_handle_tso_batch_size	histogram	Batch size of handling TSO requests
pd_server_handle_tso_duration_seconds	histogram	Duration of handling TSO requests
pd_server_handle_tso_proxy_batch_size	histogram	Batch size of TSO proxy requests
pd_server_handle_tso_proxy_duration_seconds	histogram	Duration of TSO proxy requests
pd_server_info	gauge	PD server information with start timestamp
pd_server_query_region_duration_seconds	histogram	Duration of query region operations
pd_server_region_request_cnt	counter	Counter of region requests
pd_server_tso_proxy_forward_timeout_total	counter	Counter of TSO proxy forward timeouts
pd_service_audit_handling_seconds	histogram	Duration of handling audit requests
pd_service_audit_requests_total	counter	Counter of audit requests by result
pd_service_maxprocs	gauge	GOMAXPROCS value used by PD
pd_service_memory_quota_bytes	gauge	Memory quota in bytes for PD service
pd_txn_handle_txns_duration_seconds	histogram	Duration of handling transactions
pd_txn_txns_count	counter	Counter of transactions by status
service_member_role	gauge	Role of service member (0=follower, 1=leader, 2=learner)
tikv_raftstore_snapshot_duration_seconds	histogram	Duration of Raft snapshot operations