go_memstats_heap_inuse_bytes	gauge
node_cpu_seconds_total	counter
node_disk_io_time_seconds_total	counter
node_disk_read_bytes_total	counter
node_disk_read_time_seconds_total	counter
node_disk_reads_completed_total	counter
node_disk_write_time_seconds_total	counter
node_disk_writes_completed_total	counter
node_disk_written_bytes_total	counter
pd_client_cmd_handle_cmds_duration_seconds_bucket	histogram
pd_client_request_handle_requests_duration_seconds_bucket	histogram
pd_schedule_operators_count	gauge
pd_scheduler_store_status	gauge
process_cpu_seconds_total	counter
process_resident_memory_bytes	gauge
process_start_time_seconds	gauge
raft_engine_allocate_log_duration_seconds_bucket	histogram
raft_engine_background_rewrite_bytes_sum	counter
raft_engine_log_entry_count	gauge
raft_engine_log_file_count	gauge
raft_engine_memory_usage	gauge
raft_engine_purge_duration_seconds_bucket	histogram
raft_engine_read_entry_duration_seconds_bucket	histogram
raft_engine_read_entry_duration_seconds_count	histogram
raft_engine_read_message_duration_seconds_bucket	histogram
raft_engine_read_message_duration_seconds_count	histogram
raft_engine_recycled_file_count	gauge
raft_engine_rotate_log_duration_seconds_bucket	histogram
raft_engine_swap_file_count	gauge
raft_engine_sync_log_duration_seconds_bucket	histogram
raft_engine_write_apply_duration_seconds_bucket	histogram
raft_engine_write_apply_duration_seconds_count	histogram
raft_engine_write_compression_ratio_bucket	histogram
raft_engine_write_compression_ratio_count	histogram
raft_engine_write_compression_ratio_sum	histogram
raft_engine_write_duration_seconds_bucket	histogram
raft_engine_write_duration_seconds_count	histogram
raft_engine_write_duration_seconds_sum	histogram
raft_engine_write_leader_duration_seconds_bucket	histogram
raft_engine_write_preprocess_duration_seconds_bucket	histogram
raft_engine_write_size_bucket	histogram
raft_engine_write_size_count	histogram
raft_engine_write_size_sum	histogram
raft_fetch_log	histogram
raft_term	histogram
tikv_allocator_arena_count	gauge
tikv_allocator_stats	gauge
tikv_allocator_thread_allocation	gauge
tikv_allocator_thread_stats	gauge
tikv_auto_compaction_duration_seconds_bucket	histogram
tikv_auto_compaction_duration_seconds_count	histogram
tikv_auto_compaction_duration_seconds_sum	histogram
tikv_auto_compaction_mvcc_versions_scanned_bucket	histogram
tikv_auto_compaction_mvcc_versions_scanned_count	histogram
tikv_auto_compaction_mvcc_versions_scanned_sum	histogram
tikv_auto_compaction_num_discardable_bucket	histogram
tikv_auto_compaction_num_discardable_count	histogram
tikv_auto_compaction_num_discardable_sum	histogram
tikv_auto_compaction_num_tombstones_bucket	histogram
tikv_auto_compaction_num_tombstones_count	histogram
tikv_auto_compaction_num_tombstones_sum	histogram
tikv_auto_compaction_pending_candidates	gauge
tikv_auto_compaction_regions_meet_threshold	gauge
tikv_auto_compaction_score_bucket	histogram
tikv_auto_compaction_score_count	histogram
tikv_auto_compaction_score_sum	histogram
tikv_backup_error_counter	counter
tikv_backup_range_duration_seconds_bucket	histogram
tikv_backup_range_duration_seconds_count	histogram
tikv_backup_range_duration_seconds_sum	histogram
tikv_backup_range_size_bytes_bucket	histogram
tikv_backup_range_size_bytes_sum	histogram
tikv_backup_raw_expired_count	counter
tikv_backup_softlimit	gauge
tikv_backup_thread_pool_size	gauge
tikv_batch_system_fsm_count_per_poll_bucket	histogram
tikv_batch_system_fsm_poll_rounds_bucket	histogram
tikv_batch_system_fsm_poll_seconds_bucket	histogram
tikv_batch_system_fsm_reschedule_total	counter
tikv_batch_system_fsm_schedule_wait_seconds_bucket	histogram
tikv_broadcast_normal_duration_seconds_bucket	histogram
tikv_causal_ts_provider_get_ts_duration_seconds_bucket	histogram
tikv_causal_ts_provider_get_ts_duration_seconds_count	histogram
tikv_causal_ts_provider_tso_batch_list_counting_bucket	histogram
tikv_causal_ts_provider_tso_batch_list_counting_count	histogram
tikv_causal_ts_provider_tso_batch_renew_duration_seconds_bucket	histogram
tikv_causal_ts_provider_tso_batch_renew_duration_seconds_count	histogram
tikv_causal_ts_provider_tso_batch_size	gauge
tikv_channel_full_total	counter
tikv_check_leader_request_item_count_bucket	histogram
tikv_check_leader_request_size_bytes_bucket	histogram
tikv_cloud_request_duration_seconds_count	histogram
tikv_concurrency_manager_max_ts	gauge
tikv_concurrency_manager_max_ts_limit	gauge
tikv_config_flow_control	gauge
tikv_config_raftstore	gauge
tikv_config_rocksdb	gauge
tikv_config_rocksdb_cf	gauge
tikv_config_rocksdb_db	gauge
tikv_coprocessor_dag_request_count	counter
tikv_coprocessor_executor_count	counter
tikv_coprocessor_mem_lock_check_duration_seconds_bucket	histogram
tikv_coprocessor_mem_lock_check_duration_seconds_count	histogram
tikv_coprocessor_mem_lock_check_duration_seconds_sum	histogram
tikv_coprocessor_memory_quota	gauge
tikv_coprocessor_request_duration_seconds_bucket	histogram
tikv_coprocessor_request_duration_seconds_count	histogram
tikv_coprocessor_request_duration_seconds_sum	histogram
tikv_coprocessor_request_error	counter
tikv_coprocessor_request_handle_seconds_bucket	histogram
tikv_coprocessor_request_handle_seconds_count	histogram
tikv_coprocessor_request_handle_seconds_sum	histogram
tikv_coprocessor_request_wait_seconds_bucket	histogram
tikv_coprocessor_request_wait_seconds_count	histogram
tikv_coprocessor_request_wait_seconds_sum	histogram
tikv_coprocessor_response_bytes	counter
tikv_coprocessor_rocksdb_perf	counter
tikv_coprocessor_scan_details	counter
tikv_coprocessor_scan_keys_bucket	histogram
tikv_coprocessor_scan_keys_count	histogram
tikv_coprocessor_scan_keys_sum	histogram
tikv_coprocessor_semaphore_wait_time_duration_seconds_bucket	histogram
tikv_coprocessor_semaphore_wait_time_duration_seconds_count	histogram
tikv_coprocessor_semaphore_wait_time_duration_seconds_sum	histogram
tikv_coprocessor_waiting_for_semaphore	gauge
tikv_critical_error_total	counter
tikv_encryption_data_key_storage_total	gauge
tikv_encryption_file_num	gauge
tikv_encryption_is_initialized	gauge
tikv_encryption_meta_file_size_bytes	gauge
tikv_encryption_write_read_file_duration_seconds_bucket	histogram
tikv_encryption_write_read_file_duration_seconds_count	histogram
tikv_encryption_write_read_file_duration_seconds_sum	histogram
tikv_engine_blob_cache_efficiency	counter
tikv_engine_blob_cache_size_bytes	gauge
tikv_engine_blob_file_read_micros_seconds	gauge
tikv_engine_blob_file_sync_micros_seconds	gauge
tikv_engine_blob_file_synced	counter
tikv_engine_blob_file_write_micros_seconds	gauge
tikv_engine_blob_flow_bytes	counter
tikv_engine_blob_gc_action_count	counter
tikv_engine_blob_gc_file_count	counter
tikv_engine_blob_gc_flow_bytes	counter
tikv_engine_blob_gc_input_file	gauge
tikv_engine_blob_gc_micros_seconds	gauge
tikv_engine_blob_gc_output_file	gauge
tikv_engine_blob_get_micros_seconds	gauge
tikv_engine_blob_iter_touch_blob_file_count	gauge
tikv_engine_blob_key_size	gauge
tikv_engine_blob_locate	counter
tikv_engine_blob_next_micros_seconds	gauge
tikv_engine_blob_prev_micros_seconds	gauge
tikv_engine_blob_seek_micros_seconds	gauge
tikv_engine_blob_value_size	gauge
tikv_engine_block_cache_size_bytes	gauge
tikv_engine_bloom_efficiency	counter
tikv_engine_bytes_per_read	gauge
tikv_engine_bytes_per_write	gauge
tikv_engine_cache_efficiency	counter
tikv_engine_compaction_flow_bytes	counter
tikv_engine_compaction_num_corrupt_keys	counter
tikv_engine_compaction_reason	counter
tikv_engine_compaction_time	gauge
tikv_engine_compression_ratio	gauge
tikv_engine_estimate_num_keys	gauge
tikv_engine_event_total	counter
tikv_engine_flow_bytes	counter
tikv_engine_get_micro_seconds	gauge
tikv_engine_get_served	counter
tikv_engine_ingestion_picked_level_bucket	histogram
tikv_engine_locate	counter
tikv_engine_memory_bytes	gauge
tikv_engine_memtable_efficiency	counter
tikv_engine_num_files_at_level	gauge
tikv_engine_num_files_in_single_compaction	gauge
tikv_engine_num_immutable_mem_table	gauge
tikv_engine_num_running_compactions	gauge
tikv_engine_num_running_flushes	gauge
tikv_engine_num_snapshots	gauge
tikv_engine_oldest_snapshot_duration	gauge
tikv_engine_pending_compaction_bytes	gauge
tikv_engine_read_amp_flow_bytes	counter
tikv_engine_seek_micro_seconds	gauge
tikv_engine_size_bytes	gauge
tikv_engine_sst_read_micros	gauge
tikv_engine_stall_conditions_changed	counter
tikv_engine_titandb_blob_file_discardable_ratio	gauge
tikv_engine_titandb_live_blob_file_size	gauge
tikv_engine_titandb_num_live_blob_file	gauge
tikv_engine_titandb_num_obsolete_blob_file	gauge
tikv_engine_titandb_obsolete_blob_file_size	gauge
tikv_engine_wal_file_sync_micro_seconds	gauge
tikv_engine_wal_file_synced	counter
tikv_engine_write_micro_seconds	gauge
tikv_engine_write_served	counter
tikv_engine_write_stall	gauge
tikv_engine_write_stall_reason	gauge
tikv_engine_write_wal_time_micro_seconds	gauge
tikv_external_storage_create_seconds_bucket	histogram
tikv_external_storage_create_seconds_count	histogram
tikv_external_storage_create_seconds_sum	histogram
tikv_futurepool_handled_task_total	counter
tikv_futurepool_pending_task_total	gauge
tikv_gc_compaction_failure	counter
tikv_gc_compaction_filter_mvcc_deletion_handled	counter
tikv_gc_compaction_filter_mvcc_deletion_met	counter
tikv_gc_compaction_filter_mvcc_deletion_wasted	counter
tikv_gc_compaction_filter_orphan_versions	counter
tikv_gc_compaction_filter_perform	counter
tikv_gc_compaction_filter_skip	counter
tikv_gc_compaction_filtered	counter
tikv_gc_compaction_mvcc_rollback	counter
tikv_gc_life_time	gauge
tikv_gc_run_interval	gauge
tikv_gc_worker_too_busy	counter
tikv_gcworker_autogc_processed_regions	gauge
tikv_gcworker_autogc_safe_point	gauge
tikv_gcworker_gc_keys	counter
tikv_gcworker_gc_task_duration_vec_bucket	histogram
tikv_gcworker_gc_task_duration_vec_count	histogram
tikv_gcworker_gc_task_duration_vec_sum	histogram
tikv_gcworker_gc_task_fail_vec	counter
tikv_gcworker_gc_tasks_vec	counter
tikv_grpc_batch_commands_wait_duration_seconds_bucket	histogram
tikv_grpc_msg_duration_seconds_bucket	histogram
tikv_grpc_msg_duration_seconds_count	histogram
tikv_grpc_msg_duration_seconds_sum	histogram
tikv_grpc_msg_fail_total	counter
tikv_grpc_request_source_counter_vec	counter
tikv_grpc_request_source_duration_vec	counter
tikv_grpc_resource_group_total	counter
tikv_import_applier_event	counter
tikv_import_apply_bytes_bucket	histogram
tikv_import_apply_bytes_sum	histogram
tikv_import_apply_cache_event	counter
tikv_import_apply_cached_bytes	gauge
tikv_import_apply_duration_bucket	histogram
tikv_import_download_bytes_bucket	histogram
tikv_import_download_bytes_sum	histogram
tikv_import_download_duration_bucket	histogram
tikv_import_engine_request_bucket	histogram
tikv_import_error_counter	counter
tikv_import_ingest_byte_bucket	histogram
tikv_import_ingest_duration_bucket	histogram
tikv_import_local_write_bytes	counter
tikv_import_local_write_keys	counter
tikv_import_rpc_count	gauge
tikv_import_rpc_duration_bucket	histogram
tikv_import_rpc_duration_count	histogram
tikv_import_rpc_duration_sum	histogram
tikv_in_memory_engine_auto_load_evict_cached_region_coprocessor_requests_bucket	histogram
tikv_in_memory_engine_auto_load_evict_cached_region_mvcc_amplification_bucket	histogram
tikv_in_memory_engine_auto_load_evict_top_region_coprocessor_requests_bucket	histogram
tikv_in_memory_engine_auto_load_evict_top_region_mvcc_amplification_bucket	histogram
tikv_in_memory_engine_cache_count	gauge
tikv_in_memory_engine_eviction_duration_secs_bucket	histogram
tikv_in_memory_engine_eviction_duration_secs_count	histogram
tikv_in_memory_engine_flow	counter
tikv_in_memory_engine_gc_duration_secs_bucket	histogram
tikv_in_memory_engine_gc_filtered	counter
tikv_in_memory_engine_kv_operations	counter
tikv_in_memory_engine_load_duration_secs_bucket	histogram
tikv_in_memory_engine_load_duration_secs_count	histogram
tikv_in_memory_engine_locate	counter
tikv_in_memory_engine_memory_usage_bytes	gauge
tikv_in_memory_engine_newest_safe_point	gauge
tikv_in_memory_engine_oldest_safe_point	gauge
tikv_in_memory_engine_prepare_for_write_duration_seconds_bucket	histogram
tikv_in_memory_engine_prepare_for_write_duration_seconds_count	histogram
tikv_in_memory_engine_prepare_for_write_duration_seconds_sum	histogram
tikv_in_memory_engine_seek_duration_bucket	histogram
tikv_in_memory_engine_seek_duration_count	histogram
tikv_in_memory_engine_seek_duration_sum	histogram
tikv_in_memory_engine_snapshot_acquire_failed_reason_count	counter
tikv_in_memory_engine_transfer_leader_warmup_total	counter
tikv_in_memory_engine_write_duration_seconds_bucket	histogram
tikv_in_memory_engine_write_duration_seconds_count	histogram
tikv_in_memory_engine_write_duration_seconds_sum	histogram
tikv_in_memory_pessimistic_locking	counter
tikv_io_bytes	counter
tikv_load_base_split_duration_seconds_bucket	histogram
tikv_load_base_split_duration_seconds_count	histogram
tikv_load_base_split_duration_seconds_sum	histogram
tikv_load_base_split_event	counter
tikv_lock_manager_detect_duration_bucket	histogram
tikv_lock_manager_detect_duration_count	histogram
tikv_lock_manager_detect_duration_sum	histogram
tikv_lock_manager_detector_leader_heartbeat	gauge
tikv_lock_manager_error_counter	counter
tikv_lock_manager_task_counter	counter
tikv_lock_manager_wait_table_status	gauge
tikv_lock_manager_waiter_lifetime_duration_bucket	histogram
tikv_lock_manager_waiter_lifetime_duration_count	histogram
tikv_lock_manager_waiter_lifetime_duration_sum	histogram
tikv_lock_wait_queue_entries_gauge_vec	gauge
tikv_lock_wait_queue_length_bucket	histogram
tikv_log_backup_active_subscription_number	gauge
tikv_log_backup_enabled	counter
tikv_log_backup_errors	counter
tikv_log_backup_event_handle_duration_sec_bucket	histogram
tikv_log_backup_fatal_errors	counter
tikv_log_backup_flush_duration_sec_bucket	histogram
tikv_log_backup_flush_duration_sec_count	histogram
tikv_log_backup_flush_file_size_count	histogram
tikv_log_backup_flush_file_size_sum	histogram
tikv_log_backup_handle_kv_batch_bucket	histogram
tikv_log_backup_handle_kv_batch_sum	histogram
tikv_log_backup_heap_memory	gauge
tikv_log_backup_in_disk_temp_file_size_sum	histogram
tikv_log_backup_incremental_scan_bytes_sum	histogram
tikv_log_backup_initial_scan_duration_sec_bucket	histogram
tikv_log_backup_initial_scan_operations	counter
tikv_log_backup_initial_scan_reason	counter
tikv_log_backup_internal_actor_acting_duration_sec_bucket	histogram
tikv_log_backup_internal_actor_acting_duration_sec_count	histogram
tikv_log_backup_observed_region	gauge
tikv_log_backup_on_event_duration_seconds_bucket	histogram
tikv_log_backup_pending_initial_scan	gauge
tikv_log_backup_resolve_duration_sec_bucket	histogram
tikv_log_backup_store_last_checkpoint_region_id	gauge
tikv_log_backup_store_last_checkpoint_ts	gauge
tikv_log_backup_task_status	gauge
tikv_log_backup_temp_file_count	gauge
tikv_log_backup_temp_file_memory_usage	gauge
tikv_multilevel_level0_chance	gauge
tikv_multilevel_level_elapsed	counter
tikv_non_txn_command_throttle_time_total	counter
tikv_pd_heartbeat_message_total	counter
tikv_pd_pending_heartbeat_total	gauge
tikv_pd_pending_tso_request_total	gauge
tikv_pd_reconnect_total	counter
tikv_pd_request_duration_seconds_count	histogram
tikv_pd_request_duration_seconds_sum	histogram
tikv_pd_request_forwarded	gauge
tikv_pd_validate_peer_total	counter
tikv_pessimistic_lock_memory_size	gauge
tikv_raft_apply_ahead_of_persist_bucket	histogram
tikv_raft_enable_unpersisted_apply_regions	gauge
tikv_raft_entries_evict_bytes	counter
tikv_raftstore_admin_cmd_total	counter
tikv_raftstore_append_log_duration_seconds_bucket	histogram
tikv_raftstore_append_log_duration_seconds_count	histogram
tikv_raftstore_append_log_duration_seconds_sum	histogram
tikv_raftstore_apply_duration_secs_bucket	histogram
tikv_raftstore_apply_duration_secs_count	histogram
tikv_raftstore_apply_duration_secs_sum	histogram
tikv_raftstore_apply_key_size_bucket	histogram
tikv_raftstore_apply_log_duration_seconds_bucket	histogram
tikv_raftstore_apply_log_duration_seconds_count	histogram
tikv_raftstore_apply_log_duration_seconds_sum	histogram
tikv_raftstore_apply_msg_len_bucket	histogram
tikv_raftstore_apply_perf_context_time_duration_secs_bucket	histogram
tikv_raftstore_apply_proposal_bucket	histogram
tikv_raftstore_apply_value_size_bucket	histogram
tikv_raftstore_apply_wait_time_duration_secs_bucket	histogram
tikv_raftstore_apply_wait_time_duration_secs_count	histogram
tikv_raftstore_apply_wait_time_duration_secs_sum	histogram
tikv_raftstore_check_split_duration_seconds_bucket	histogram
tikv_raftstore_check_split_total	counter
tikv_raftstore_check_stale_peer	counter
tikv_raftstore_clean_region_count	counter
tikv_raftstore_clear_overlap_region_duration_seconds_bucket	histogram
tikv_raftstore_clear_overlap_region_duration_seconds_count	histogram
tikv_raftstore_clear_overlap_region_duration_seconds_sum	histogram
tikv_raftstore_commit_log_duration_seconds_bucket	histogram
tikv_raftstore_commit_log_duration_seconds_count	histogram
tikv_raftstore_commit_log_duration_seconds_sum	histogram
tikv_raftstore_compaction_guard_action_total	counter
tikv_raftstore_entry_fetches	counter
tikv_raftstore_entry_fetches_task_duration_seconds_bucket	histogram
tikv_raftstore_entry_fetches_task_duration_seconds_count	histogram
tikv_raftstore_entry_fetches_task_duration_seconds_sum	histogram
tikv_raftstore_event_duration_bucket	histogram
tikv_raftstore_hibernated_peer_state	gauge
tikv_raftstore_inspect_duration_seconds_bucket	histogram
tikv_raftstore_io_duration_seconds_bucket	histogram
tikv_raftstore_io_duration_seconds_count	histogram
tikv_raftstore_io_duration_seconds_sum	histogram
tikv_raftstore_io_reschedule_pending_tasks_total	gauge
tikv_raftstore_io_reschedule_region_total	gauge
tikv_raftstore_leader_missing	gauge
tikv_raftstore_local_read_executed_follower_read_requests	counter
tikv_raftstore_local_read_executed_requests	counter
tikv_raftstore_local_read_executed_stale_read_requests	counter
tikv_raftstore_local_read_received_follower_read_requests	counter
tikv_raftstore_local_read_received_requests	counter
tikv_raftstore_local_read_received_stale_read_requests	counter
tikv_raftstore_local_read_reject_total	counter
tikv_raftstore_log_lag_sum	histogram
tikv_raftstore_peer_in_flashback_state	gauge
tikv_raftstore_peer_msg_len_bucket	histogram
tikv_raftstore_process_busy	gauge
tikv_raftstore_proposal_total	counter
tikv_raftstore_propose_log_size_sum	histogram
tikv_raftstore_raft_dropped_message_total	counter
tikv_raftstore_raft_log_gc_failed	counter
tikv_raftstore_raft_log_gc_seek_operations_count	counter
tikv_raftstore_raft_log_gc_skipped	counter
tikv_raftstore_raft_log_gc_write_duration_secs_bucket	histogram
tikv_raftstore_raft_log_gc_write_duration_secs_count	histogram
tikv_raftstore_raft_log_gc_write_duration_secs_sum	histogram
tikv_raftstore_raft_log_kv_sync_duration_secs_bucket	histogram
tikv_raftstore_raft_log_kv_sync_duration_secs_count	histogram
tikv_raftstore_raft_log_kv_sync_duration_secs_sum	histogram
tikv_raftstore_raft_process_duration_secs_bucket	histogram
tikv_raftstore_raft_process_duration_secs_count	histogram
tikv_raftstore_raft_process_duration_secs_sum	histogram
tikv_raftstore_raft_ready_handled_total	counter
tikv_raftstore_raft_sent_message_total	counter
tikv_raftstore_region_count	gauge
tikv_raftstore_region_size_bucket	histogram
tikv_raftstore_region_size_count	histogram
tikv_raftstore_region_size_sum	histogram
tikv_raftstore_request_wait_time_duration_secs_bucket	histogram
tikv_raftstore_request_wait_time_duration_secs_count	histogram
tikv_raftstore_request_wait_time_duration_secs_sum	histogram
tikv_raftstore_slow_score	gauge
tikv_raftstore_slow_trend	gauge
tikv_raftstore_slow_trend_l0	gauge
tikv_raftstore_slow_trend_result	gauge
tikv_raftstore_slow_trend_result_value	gauge
tikv_raftstore_snapshot_apply_wait_duration_seconds_bucket	histogram
tikv_raftstore_snapshot_duration_seconds_bucket	histogram
tikv_raftstore_snapshot_generation_wait_duration_seconds_bucket	histogram
tikv_raftstore_snapshot_pending_applies	gauge
tikv_raftstore_snapshot_total	counter
tikv_raftstore_snapshot_traffic_total	gauge
tikv_raftstore_store_duration_secs_bucket	histogram
tikv_raftstore_store_duration_secs_count	histogram
tikv_raftstore_store_duration_secs_sum	histogram
tikv_raftstore_store_perf_context_time_duration_secs_bucket	histogram
tikv_raftstore_store_wf_batch_wait_duration_seconds_bucket	histogram
tikv_raftstore_store_wf_batch_wait_duration_seconds_count	histogram
tikv_raftstore_store_wf_batch_wait_duration_seconds_sum	histogram
tikv_raftstore_store_wf_before_write_duration_seconds_bucket	histogram
tikv_raftstore_store_wf_before_write_duration_seconds_count	histogram
tikv_raftstore_store_wf_before_write_duration_seconds_sum	histogram
tikv_raftstore_store_wf_commit_log_duration_seconds_bucket	histogram
tikv_raftstore_store_wf_commit_log_duration_seconds_count	histogram
tikv_raftstore_store_wf_commit_log_duration_seconds_sum	histogram
tikv_raftstore_store_wf_commit_not_persist_log_duration_seconds_bucket	histogram
tikv_raftstore_store_wf_commit_not_persist_log_duration_seconds_count	histogram
tikv_raftstore_store_wf_commit_not_persist_log_duration_seconds_sum	histogram
tikv_raftstore_store_wf_persist_duration_seconds_bucket	histogram
tikv_raftstore_store_wf_persist_duration_seconds_count	histogram
tikv_raftstore_store_wf_persist_duration_seconds_sum	histogram
tikv_raftstore_store_wf_send_proposal_duration_seconds_bucket	histogram
tikv_raftstore_store_wf_send_proposal_duration_seconds_count	histogram
tikv_raftstore_store_wf_send_proposal_duration_seconds_sum	histogram
tikv_raftstore_store_wf_send_to_queue_duration_seconds_bucket	histogram
tikv_raftstore_store_wf_send_to_queue_duration_seconds_count	histogram
tikv_raftstore_store_wf_send_to_queue_duration_seconds_sum	histogram
tikv_raftstore_store_wf_write_end_duration_seconds_bucket	histogram
tikv_raftstore_store_wf_write_end_duration_seconds_count	histogram
tikv_raftstore_store_wf_write_end_duration_seconds_sum	histogram
tikv_raftstore_store_wf_write_kvdb_end_duration_seconds_bucket	histogram
tikv_raftstore_store_wf_write_kvdb_end_duration_seconds_count	histogram
tikv_raftstore_store_wf_write_kvdb_end_duration_seconds_sum	histogram
tikv_raftstore_store_write_handle_msg_duration_secs_bucket	histogram
tikv_raftstore_store_write_loop_duration_seconds_bucket	histogram
tikv_raftstore_store_write_loop_duration_seconds_count	histogram
tikv_raftstore_store_write_loop_duration_seconds_sum	histogram
tikv_raftstore_store_write_msg_block_wait_duration_seconds_bucket	histogram
tikv_raftstore_store_write_msg_block_wait_duration_seconds_count	histogram
tikv_raftstore_store_write_task_wait_duration_secs_bucket	histogram
tikv_raftstore_store_write_task_wait_duration_secs_count	histogram
tikv_raftstore_store_write_task_wait_duration_secs_sum	histogram
tikv_raftstore_store_write_trigger_wb_bytes_bucket	histogram
tikv_rate_limiter_max_bytes_per_sec	gauge
tikv_rate_limiter_request_wait_duration_seconds_bucket	histogram
tikv_rate_limiter_request_wait_duration_seconds_count	histogram
tikv_rate_limiter_request_wait_duration_seconds_sum	histogram
tikv_region_written_bytes_bucket	histogram
tikv_region_written_bytes_count	histogram
tikv_region_written_bytes_sum	histogram
tikv_region_written_keys_bucket	histogram
tikv_region_written_keys_count	histogram
tikv_region_written_keys_sum	histogram
tikv_replica_read_lock_check_duration_seconds_bucket	histogram
tikv_resolved_ts_channel_pending_cmd_bytes_total	gauge
tikv_resolved_ts_check_leader_duration_seconds_bucket	histogram
tikv_resolved_ts_fail_advance_count	counter
tikv_resolved_ts_initial_scan_backoff_duration_seconds_bucket	histogram
tikv_resolved_ts_lock_heap_bytes	gauge
tikv_resolved_ts_min_follower_safe_ts_gap_millis	gauge
tikv_resolved_ts_min_follower_safe_ts_region	gauge
tikv_resolved_ts_min_leader_resolved_ts_gap_millis	gauge
tikv_resolved_ts_min_leader_resolved_ts_region	gauge
tikv_resolved_ts_min_resolved_ts_gap_millis	gauge
tikv_resolved_ts_min_resolved_ts_region	gauge
tikv_resolved_ts_region_resolve_status	gauge
tikv_resource_control_background_task_wait_duration	counter
tikv_resource_control_priority_quota_limit	gauge
tikv_rocksdb_damaged_files	gauge
tikv_rocksdb_damaged_files_deleted	counter
tikv_safe_point_gap_with_in_memory_engine	gauge
tikv_scheduler_block_read_duration_seconds_bucket	histogram
tikv_scheduler_block_read_duration_seconds_count	histogram
tikv_scheduler_block_read_duration_seconds_sum	histogram
tikv_scheduler_command_duration_seconds_bucket	histogram
tikv_scheduler_command_duration_seconds_count	histogram
tikv_scheduler_command_duration_seconds_sum	histogram
tikv_scheduler_commands_pri_total	counter
tikv_scheduler_contex_total	gauge
tikv_scheduler_discard_ratio	gauge
tikv_scheduler_flush_flow	gauge
tikv_scheduler_kv_command_key_read_bucket	histogram
tikv_scheduler_kv_command_key_read_count	histogram
tikv_scheduler_kv_command_key_read_sum	histogram
tikv_scheduler_kv_command_key_write_bucket	histogram
tikv_scheduler_kv_command_key_write_count	histogram
tikv_scheduler_kv_command_key_write_sum	histogram
tikv_scheduler_kv_scan_details	counter
tikv_scheduler_l0	gauge
tikv_scheduler_l0_avg	gauge
tikv_scheduler_l0_flow	gauge
tikv_scheduler_latch_wait_duration_seconds_bucket	histogram
tikv_scheduler_latch_wait_duration_seconds_count	histogram
tikv_scheduler_latch_wait_duration_seconds_sum	histogram
tikv_scheduler_memory_quota_size	gauge
tikv_scheduler_memtable	gauge
tikv_scheduler_pending_compaction_bytes	gauge
tikv_scheduler_processing_read_duration_seconds_bucket	histogram
tikv_scheduler_processing_read_duration_seconds_count	histogram
tikv_scheduler_processing_read_duration_seconds_sum	histogram
tikv_scheduler_running_commands	gauge
tikv_scheduler_stage_total	counter
tikv_scheduler_throttle_action_total	counter
tikv_scheduler_throttle_cf	gauge
tikv_scheduler_throttle_duration_seconds_bucket	histogram
tikv_scheduler_throttle_flow	gauge
tikv_scheduler_too_busy_total	counter
tikv_scheduler_wait_for_process_duration_seconds_bucket	histogram
tikv_scheduler_write_flow	gauge
tikv_scheduler_writing_bytes	gauge
tikv_server_address_resolve_duration_secs_bucket	histogram
tikv_server_cpu_cores_quota	gauge
tikv_server_grpc_req_batch_size_bucket	histogram
tikv_server_grpc_req_batch_size_count	histogram
tikv_server_grpc_req_batch_size_sum	histogram
tikv_server_grpc_resp_batch_size_bucket	histogram
tikv_server_grpc_resp_batch_size_count	histogram
tikv_server_grpc_resp_batch_size_sum	histogram
tikv_server_mem_trace_sum	gauge
tikv_server_memory_quota_bytes	gauge
tikv_server_raft_append_rejects	counter
tikv_server_raft_client_wait_ready_duration_bucket	histogram
tikv_server_raft_client_wait_ready_duration_count	histogram
tikv_server_raft_client_wait_ready_duration_sum	histogram
tikv_server_raft_message_batch_size_bucket	histogram
tikv_server_raft_message_batch_size_count	histogram
tikv_server_raft_message_batch_size_sum	histogram
tikv_server_raft_message_duration_seconds_bucket	histogram
tikv_server_raft_message_duration_seconds_count	histogram
tikv_server_raft_message_duration_seconds_sum	histogram
tikv_server_raft_message_flush_total	counter
tikv_server_raft_message_recv_total	counter
tikv_server_raft_store_msg_total	counter
tikv_server_report_failure_msg_total	counter
tikv_server_request_batch_size_bucket	histogram
tikv_server_request_batch_size_count	histogram
tikv_server_request_batch_size_sum	histogram
tikv_server_send_snapshot_duration_seconds_bucket	histogram
tikv_server_snapshot_task_total	counter
tikv_snapshot_kv_count_bucket	histogram
tikv_snapshot_limit_generate_bytes	counter
tikv_snapshot_limit_transport_bytes	counter
tikv_snapshot_size_bucket	histogram
tikv_snapshot_type_count	counter
tikv_status_server_request_duration_seconds_bucket	histogram
tikv_status_server_request_duration_seconds_count	histogram
tikv_status_server_request_duration_seconds_sum	histogram
tikv_storage_check_mem_lock_duration_seconds_bucket	histogram
tikv_storage_command_total	counter
tikv_storage_engine_async_request_duration_seconds_bucket	histogram
tikv_storage_engine_async_request_duration_seconds_count	histogram
tikv_storage_engine_async_request_duration_seconds_sum	histogram
tikv_storage_engine_async_request_total	counter
tikv_storage_full_compact_duration_seconds_bucket	histogram
tikv_storage_full_compact_duration_seconds_count	histogram
tikv_storage_full_compact_duration_seconds_sum	histogram
tikv_storage_full_compact_increment_duration_seconds_bucket	histogram
tikv_storage_full_compact_increment_duration_seconds_count	histogram
tikv_storage_full_compact_increment_duration_seconds_sum	histogram
tikv_storage_full_compact_pause_duration_seconds_bucket	histogram
tikv_storage_full_compact_pause_duration_seconds_count	histogram
tikv_storage_full_compact_pause_duration_seconds_sum	histogram
tikv_storage_gc_skipped_counter	counter
tikv_storage_ingest_external_file_allow_write_counter	counter
tikv_storage_ingest_external_file_duration_secs_bucket	histogram
tikv_storage_ingest_external_file_duration_secs_count	histogram
tikv_storage_ingest_external_file_duration_secs_sum	histogram
tikv_storage_mvcc_gc_delete_versions_sum	histogram
tikv_storage_mvcc_scan_lock_read_duration_seconds_bucket	histogram
tikv_storage_mvcc_scan_lock_read_duration_seconds_count	histogram
tikv_storage_mvcc_scan_lock_read_duration_seconds_sum	histogram
tikv_storage_process_stat_cpu_usage	gauge
tikv_storage_rocksdb_perf	counter
tikv_store_size_bytes	gauge
tikv_thread_cpu_seconds_total	gauge
tikv_thread_nonvoluntary_context_switches	gauge
tikv_thread_voluntary_context_switches	gauge
tikv_threads_io_bytes_total	gauge
tikv_threads_state	gauge
tikv_ttl_checker_actions	counter
tikv_ttl_checker_compact_duration_bucket	histogram
tikv_ttl_checker_compact_duration_count	histogram
tikv_ttl_checker_compact_duration_sum	histogram
tikv_ttl_checker_poll_interval	gauge
tikv_ttl_checker_processed_regions	gauge
tikv_ttl_expire_kv_count_total	counter
tikv_ttl_expire_kv_size_total	counter
tikv_txn_command_throttle_time_total	counter
tikv_unified_read_pool_running_tasks	gauge
tikv_unified_read_pool_thread_count	gauge
tikv_worker_handled_task_total	counter
tikv_worker_pending_task_total	gauge
tikv_yatp_pool_schedule_exec_duration_bucket	histogram
tikv_yatp_pool_schedule_wait_duration_bucket	histogram
tikv_yatp_pool_schedule_wait_duration_count	histogram
tikv_yatp_pool_schedule_wait_duration_sum	histogram
tikv_yatp_task_exec_duration_bucket	histogram
tikv_yatp_task_exec_duration_count	histogram
tikv_yatp_task_exec_duration_sum	histogram
tikv_yatp_task_execute_times_bucket	histogram
tikv_yatp_task_execute_times_count	histogram
tikv_yatp_task_execute_times_sum	histogram
tikv_yatp_task_poll_duration_bucket	histogram
tikv_yatp_task_poll_duration_count	histogram
tikv_yatp_task_poll_duration_sum	histogram
