go_cpu_classes_gc_mark_assist_cpu_seconds_total	counter
go_cpu_classes_gc_mark_dedicated_cpu_seconds_total	counter
go_cpu_classes_gc_mark_idle_cpu_seconds_total	counter
go_cpu_classes_gc_pause_cpu_seconds_total	counter
go_cpu_classes_gc_total_cpu_seconds_total	counter
go_cpu_classes_idle_cpu_seconds_total	counter
go_cpu_classes_scavenge_assist_cpu_seconds_total	counter
go_cpu_classes_scavenge_background_cpu_seconds_total	counter
go_cpu_classes_scavenge_total_cpu_seconds_total	counter
go_cpu_classes_total_cpu_seconds_total	counter
go_cpu_classes_user_cpu_seconds_total	counter
go_gc_cycles_automatic_gc_cycles_total	counter
go_gc_cycles_forced_gc_cycles_total	counter
go_gc_cycles_total_gc_cycles_total	counter
go_gc_duration_seconds	summary
go_gc_gogc_percent	gauge
go_gc_gomemlimit_bytes	gauge
go_gc_heap_allocs_by_size_bytes_bucket	histogram
go_gc_heap_allocs_by_size_bytes_count	histogram
go_gc_heap_allocs_by_size_bytes_sum	histogram
go_gc_heap_allocs_bytes_total	counter
go_gc_heap_allocs_objects_total	counter
go_gc_heap_frees_by_size_bytes_bucket	histogram
go_gc_heap_frees_by_size_bytes_count	histogram
go_gc_heap_frees_by_size_bytes_sum	histogram
go_gc_heap_frees_bytes_total	counter
go_gc_heap_frees_objects_total	counter
go_gc_heap_goal_bytes	gauge
go_gc_limiter_last_enabled_gc_cycle	gauge
go_goroutines	gauge
go_memory_classes_heap_free_bytes	gauge
go_memory_classes_heap_objects_bytes	gauge
go_memory_classes_heap_released_bytes	gauge
go_memory_classes_heap_stacks_bytes	gauge
go_memory_classes_heap_unused_bytes	gauge
go_memory_classes_metadata_mcache_free_bytes	gauge
go_memory_classes_metadata_mcache_inuse_bytes	gauge
go_memory_classes_metadata_mspan_free_bytes	gauge
go_memory_classes_metadata_mspan_inuse_bytes	gauge
go_memory_classes_metadata_other_bytes	gauge
go_memory_classes_os_stacks_bytes	gauge
go_memory_classes_other_bytes	gauge
go_memory_classes_profiling_buckets_bytes	gauge
go_memstats_alloc_bytes_total	counter
go_memstats_frees_total	counter
go_memstats_gc_cpu_fraction	gauge
go_memstats_heap_alloc_bytes	gauge
go_memstats_heap_inuse_bytes	gauge
go_memstats_heap_objects	gauge
go_memstats_last_gc_time_seconds	gauge
go_memstats_mallocs_total	counter
go_sched_goroutines_goroutines	gauge
go_sched_latencies_seconds_bucket	histogram
go_sched_pauses_stopping_gc_seconds_bucket	histogram
go_sched_pauses_stopping_gc_seconds_count	histogram
go_sched_pauses_stopping_gc_seconds_sum	histogram
go_sched_pauses_stopping_other_seconds_bucket	histogram
go_sched_pauses_stopping_other_seconds_count	histogram
go_sched_pauses_stopping_other_seconds_sum	histogram
go_sched_pauses_total_gc_seconds_bucket	histogram
go_sched_pauses_total_gc_seconds_count	histogram
go_sched_pauses_total_gc_seconds_sum	histogram
go_sched_pauses_total_other_seconds_bucket	histogram
go_sched_pauses_total_other_seconds_count	histogram
go_sched_pauses_total_other_seconds_sum	histogram
go_sync_mutex_wait_total_seconds_total	counter
go_threads	gauge
grpc_server_handling_seconds_bucket	histogram
lightning_apply_worker_seconds_count	gauge
lightning_apply_worker_seconds_sum	gauge
lightning_block_deliver_bytes_sum	gauge
lightning_block_deliver_seconds_count	gauge
lightning_block_deliver_seconds_sum	gauge
lightning_bytes	gauge
lightning_chunk_parser_read_block_seconds_count	gauge
lightning_chunk_parser_read_block_seconds_sum	gauge
lightning_chunks	gauge
lightning_idle_workers	gauge
lightning_importer_engine	gauge
lightning_kv_encoder	gauge
lightning_row_encode_seconds_count	gauge
lightning_row_encode_seconds_sum	gauge
lightning_row_kv_deliver_seconds_count	gauge
lightning_row_kv_deliver_seconds_sum	gauge
lightning_row_read_bytes_sum	gauge
lightning_sst_seconds_count	gauge
lightning_sst_seconds_sum	gauge
lightning_tables	gauge
node_cpu_seconds_total	counter
node_disk_io_time_seconds_total	counter
node_disk_read_bytes_total	counter
node_disk_reads_completed_total	counter
node_disk_writes_completed_total	counter
node_disk_written_bytes_total	counter
node_load1	gauge
node_memory_MemAvailable_bytes	gauge
node_memory_MemTotal_bytes	gauge
node_netstat_Tcp_RetransSegs	gauge
node_network_receive_bytes_total	counter
node_network_transmit_bytes_total	counter
pd_client_cmd_handle_cmds_duration_seconds_bucket	histogram
pd_client_cmd_handle_cmds_duration_seconds_count	histogram
pd_client_cmd_handle_cmds_duration_seconds_sum	histogram
pd_client_cmd_handle_failed_cmds_duration_seconds_count	gauge
pd_client_request_estimate_tso_latency	gauge
pd_client_request_handle_requests_duration_seconds_bucket	histogram
pd_client_request_handle_requests_duration_seconds_count	histogram
pd_client_request_handle_requests_duration_seconds_sum	histogram
pd_cluster_status	gauge
pd_config_status	gauge
pd_hotspot_status	gauge
pd_regions_status	gauge
pd_scheduler_region_heartbeat	gauge
pd_scheduler_region_heartbeat_latency_seconds_bucket	histogram
pd_server_handle_tso_duration_seconds_bucket	histogram
pd_server_handle_tso_duration_seconds_count	histogram
pd_server_handle_tso_duration_seconds_sum	histogram
pd_service_maxprocs	gauge
pd_tso_role	gauge
probe_success	gauge
process_cpu_seconds_total	counter
process_open_fds	gauge
process_resident_memory_bytes	gauge
process_start_time_seconds	gauge
resource_manager_client_request_fail	gauge
resource_manager_client_request_success_bucket	histogram
resource_manager_client_request_success_count	histogram
resource_manager_client_resource_group_status	gauge
resource_manager_client_token_request_duration_bucket	histogram
resource_manager_client_token_request_duration_count	histogram
resource_manager_client_token_request_resource_group	gauge
resource_manager_resource_kv_cpu_time_ms_sum	gauge
resource_manager_resource_read_byte_sum	gauge
resource_manager_resource_request_count	gauge
resource_manager_resource_sql_cpu_time_ms_sum	gauge
resource_manager_resource_unit_read_request_unit_max_per_sec	gauge
resource_manager_resource_unit_read_request_unit_sum	gauge
resource_manager_resource_unit_write_request_unit_max_per_sec	gauge
resource_manager_resource_unit_write_request_unit_sum	gauge
resource_manager_resource_write_byte_sum	gauge
resource_manager_server_group_config	gauge
ticdc_mounter_total_rows_count	gauge
ticdc_owner_checkpoint_ts_lag	gauge
ticdc_owner_resolved_ts_lag	gauge
ticdc_owner_status	gauge
ticdc_processor_checkpoint_ts_lag	gauge
ticdc_processor_resolved_ts_lag	gauge
ticdc_puller_txn_collect_event_count	gauge
ticdc_server_go_max_procs	gauge
ticdc_sink_table_sink_total_rows_count	gauge
ticdc_sinkv2_batch_row_count_sum	gauge
ticdc_sinkv2_kafka_producer_outgoing_byte_rate	gauge
ticdc_sinkv2_mq_worker_send_message_duration_bucket	histogram
ticdc_sinkv2_mq_worker_send_message_duration_count	histogram
ticdc_sinkv2_mq_worker_send_message_duration_sum	histogram
ticdc_sinkv2_txn_worker_flush_duration_bucket	histogram
ticdc_sinkv2_txn_worker_flush_duration_count	histogram
ticdc_sinkv2_txn_worker_flush_duration_sum	histogram
ticdc_sorter_output_event_count	gauge
tidb_autoid_operation_duration_seconds_bucket	histogram
tidb_autoid_operation_duration_seconds_count	histogram
tidb_ddl_add_index_total	counter
tidb_ddl_backfill_percentage_progress	gauge
tidb_ddl_batch_add_idx_duration_seconds_bucket	histogram
tidb_ddl_bytes	gauge
tidb_ddl_deploy_syncer_duration_seconds_bucket	histogram
tidb_ddl_handle_job_duration_seconds_bucket	histogram
tidb_ddl_handle_job_duration_seconds_count	histogram
tidb_ddl_job_table_duration_seconds_bucket	histogram
tidb_ddl_owner_handle_syncer_duration_seconds_bucket	histogram
tidb_ddl_running_job_count	gauge
tidb_ddl_scan_rate_bucket	histogram
tidb_ddl_temp_index_op_count	gauge
tidb_ddl_update_self_ver_duration_seconds_bucket	histogram
tidb_ddl_waiting_jobs	gauge
tidb_ddl_worker_operation_duration_seconds_bucket	histogram
tidb_ddl_worker_operation_total	counter
tidb_distsql_copr_cache	gauge
tidb_distsql_copr_closest_read	gauge
tidb_distsql_copr_resp_size_bucket	histogram
tidb_distsql_copr_resp_size_count	histogram
tidb_distsql_copr_resp_size_sum	histogram
tidb_distsql_handle_query_duration_seconds_bucket	histogram
tidb_distsql_handle_query_duration_seconds_count	histogram
tidb_distsql_partial_num_bucket	histogram
tidb_distsql_scan_keys_num_bucket	histogram
tidb_distsql_scan_keys_partial_num_bucket	histogram
tidb_distsql_scan_keys_partial_num_count	histogram
tidb_disttask_subtask_duration	gauge
tidb_disttask_subtasks	gauge
tidb_disttask_task_status	gauge
tidb_disttask_used_slots	gauge
tidb_domain_infocache_counters	gauge
tidb_domain_infoschema_v2_cache	gauge
tidb_domain_infoschema_v2_cache_limit	gauge
tidb_domain_infoschema_v2_cache_size	gauge
tidb_domain_lease_expire_time	gauge
tidb_domain_load_schema_duration_seconds_bucket	histogram
tidb_domain_load_schema_total	counter
tidb_executor_affected_rows	gauge
tidb_executor_expensive_total	counter
tidb_executor_mpp_coordinator_latency_bucket	histogram
tidb_executor_mpp_coordinator_stats	gauge
tidb_executor_ongoing_txn_duration_seconds_bucket	histogram
tidb_executor_statement_total	counter
tidb_global_sort_ingest_worker_cnt	gauge
tidb_global_sort_read_from_cloud_storage_duration_bucket	histogram
tidb_global_sort_read_from_cloud_storage_rate_bucket	histogram
tidb_global_sort_upload_worker_cnt	gauge
tidb_global_sort_write_to_cloud_storage_duration_bucket	histogram
tidb_global_sort_write_to_cloud_storage_rate_bucket	histogram
tidb_import_block_deliver_kv_pairs_sum	gauge
tidb_import_block_deliver_seconds_count	gauge
tidb_import_block_deliver_seconds_sum	gauge
tidb_import_bytes	gauge
tidb_import_row_encode_seconds_count	gauge
tidb_import_row_encode_seconds_sum	gauge
tidb_import_row_read_seconds_count	gauge
tidb_import_row_read_seconds_sum	gauge
tidb_infoschema_table_by_name_duration_nanoseconds_bucket	histogram
tidb_infoschema_table_by_name_duration_nanoseconds_count	histogram
tidb_infoschema_table_by_name_duration_nanoseconds_sum	histogram
tidb_meta_autoid_client_conn_reset_total	counter
tidb_meta_operation_duration_seconds_bucket	histogram
tidb_monitor_keep_alive_total	counter
tidb_monitor_time_jump_back_total	counter
tidb_owner_new_session_duration_seconds_bucket	histogram
tidb_owner_watch_owner_total	counter
tidb_plan_replayer_register_task	gauge
tidb_plan_replayer_task	gauge
tidb_rm_ema_cpu_usage	gauge
tidb_server_binding_cache_hit_total	counter
tidb_server_binding_cache_mem_limit	gauge
tidb_server_binding_cache_mem_usage	gauge
tidb_server_binding_cache_miss_total	counter
tidb_server_binding_cache_num_bindings	gauge
tidb_server_conn_idle_duration_seconds_bucket	histogram
tidb_server_conn_idle_duration_seconds_count	histogram
tidb_server_conn_idle_duration_seconds_sum	histogram
tidb_server_connections	gauge
tidb_server_cpu_profile_total	counter
tidb_server_critical_error_total	counter
tidb_server_disconnection_total	counter
tidb_server_event_total	counter
tidb_server_execute_error_total	counter
tidb_server_get_token_duration_seconds_bucket	histogram
tidb_server_get_token_duration_seconds_sum	histogram
tidb_server_gogc	gauge
tidb_server_handle_query_duration_seconds_bucket	histogram
tidb_server_handle_query_duration_seconds_count	histogram
tidb_server_handle_query_duration_seconds_sum	histogram
tidb_server_handshake_error_total	counter
tidb_server_internal_sessions	gauge
tidb_server_load_table_cache_seconds_bucket	histogram
tidb_server_maxprocs	gauge
tidb_server_memory_quota_bytes	gauge
tidb_server_memory_usage	gauge
tidb_server_multi_query_num_count	gauge
tidb_server_multi_query_num_sum	gauge
tidb_server_packet_io_bytes	gauge
tidb_server_panic_total	counter
tidb_server_pd_api_execution_duration_seconds_bucket	histogram
tidb_server_pd_api_request_total	counter
tidb_server_plan_cache_instance_memory_usage	gauge
tidb_server_plan_cache_instance_plan_num_total	gauge
tidb_server_plan_cache_miss_total	counter
tidb_server_plan_cache_total	counter
tidb_server_prepared_stmts	gauge
tidb_server_query_runaway_check	gauge
tidb_server_query_total	counter
tidb_server_rc_check_ts_conflict_total	counter
tidb_server_read_from_tablecache_total	counter
tidb_server_slow_query_cop_duration_seconds_bucket	histogram
tidb_server_slow_query_cop_mvcc_ratio_bucket	histogram
tidb_server_slow_query_process_duration_seconds_bucket	histogram
tidb_server_slow_query_wait_duration_seconds_bucket	histogram
tidb_server_timer_event_count	gauge
tidb_server_tokens	gauge
tidb_server_ttl_event_count	gauge
tidb_server_ttl_insert_rows	gauge
tidb_server_ttl_job_status	gauge
tidb_server_ttl_phase_time	gauge
tidb_server_ttl_processed_expired_rows	gauge
tidb_server_ttl_query_duration_bucket	histogram
tidb_server_ttl_query_duration_count	histogram
tidb_server_ttl_task_status	gauge
tidb_server_ttl_watermark_delay	gauge
tidb_session_compile_duration_seconds_bucket	histogram
tidb_session_compile_duration_seconds_count	histogram
tidb_session_compile_duration_seconds_sum	histogram
tidb_session_execute_duration_seconds_bucket	histogram
tidb_session_execute_duration_seconds_count	histogram
tidb_session_execute_duration_seconds_sum	histogram
tidb_session_parse_duration_seconds_bucket	histogram
tidb_session_parse_duration_seconds_count	histogram
tidb_session_parse_duration_seconds_sum	histogram
tidb_session_resource_group_query_total	counter
tidb_session_restricted_sql_total	counter
tidb_session_retry_error_total	counter
tidb_session_retry_num_bucket	histogram
tidb_session_schema_lease_error_total	counter
tidb_session_statement_lock_keys_count_bucket	histogram
tidb_session_statement_pessimistic_retry_count_bucket	histogram
tidb_session_transaction_duration_seconds_bucket	histogram
tidb_session_transaction_duration_seconds_count	histogram
tidb_session_transaction_duration_seconds_sum	histogram
tidb_session_transaction_fair_locking_usage	gauge
tidb_session_transaction_statement_num_bucket	histogram
tidb_session_txn_state_entering_count	gauge
tidb_session_txn_state_seconds_bucket	histogram
tidb_session_txn_state_seconds_count	histogram
tidb_session_txn_state_seconds_sum	histogram
tidb_statistics_auto_analyze_duration_seconds_bucket	histogram
tidb_statistics_auto_analyze_total	counter
tidb_statistics_historical_stats	gauge
tidb_statistics_pseudo_estimation_total	counter
tidb_statistics_read_stats_latency_millis_bucket	histogram
tidb_statistics_stats_cache_op	gauge
tidb_statistics_stats_cache_val	gauge
tidb_statistics_stats_delta_load_duration_seconds_bucket	histogram
tidb_statistics_stats_delta_update_duration_seconds_bucket	histogram
tidb_statistics_stats_healthy	gauge
tidb_statistics_stats_inaccuracy_rate_bucket	histogram
tidb_statistics_stats_usage_update_duration_seconds_bucket	histogram
tidb_statistics_sync_load_dedup_total	counter
tidb_statistics_sync_load_latency_millis_bucket	histogram
tidb_statistics_sync_load_timeout_total	counter
tidb_statistics_sync_load_total	counter
tidb_statistics_update_stats_total	counter
tidb_tikvclient_aggressive_locking_count	gauge
tidb_tikvclient_async_commit_txn_counter	gauge
tidb_tikvclient_backoff_seconds_bucket	histogram
tidb_tikvclient_backoff_seconds_count	histogram
tidb_tikvclient_batch_client_no_available_connection_total	counter
tidb_tikvclient_batch_client_unavailable_seconds_bucket	histogram
tidb_tikvclient_batch_client_wait_connection_establish_bucket	histogram
tidb_tikvclient_batch_executor_token_wait_duration_bucket	histogram
tidb_tikvclient_batch_pending_requests_bucket	histogram
tidb_tikvclient_batch_recv_latency_bucket	histogram
tidb_tikvclient_batch_recv_latency_count	histogram
tidb_tikvclient_batch_recv_latency_sum	histogram
tidb_tikvclient_batch_requests_bucket	histogram
tidb_tikvclient_batch_send_latency_bucket	histogram
tidb_tikvclient_batch_wait_duration_bucket	histogram
tidb_tikvclient_commit_txn_counter	gauge
tidb_tikvclient_feedback_slow_score	gauge
tidb_tikvclient_forward_request_counter	gauge
tidb_tikvclient_gc_action_result	gauge
tidb_tikvclient_gc_config	gauge
tidb_tikvclient_gc_failure	gauge
tidb_tikvclient_gc_region_too_many_locks	gauge
tidb_tikvclient_gc_seconds_bucket	histogram
tidb_tikvclient_gc_unsafe_destroy_range_failures	gauge
tidb_tikvclient_gc_worker_actions_total	counter
tidb_tikvclient_load_region_cache_seconds_bucket	histogram
tidb_tikvclient_load_region_cache_seconds_count	histogram
tidb_tikvclient_load_region_cache_seconds_sum	histogram
tidb_tikvclient_load_safepoint_total	counter
tidb_tikvclient_lock_resolver_actions_total	counter
tidb_tikvclient_min_safets_gap_seconds	gauge
tidb_tikvclient_one_pc_txn_counter	gauge
tidb_tikvclient_pessimistic_lock_keys_duration_bucket	histogram
tidb_tikvclient_pipelined_flush_duration_bucket	histogram
tidb_tikvclient_pipelined_flush_duration_count	histogram
tidb_tikvclient_pipelined_flush_duration_sum	histogram
tidb_tikvclient_pipelined_flush_len_bucket	histogram
tidb_tikvclient_pipelined_flush_size_bucket	histogram
tidb_tikvclient_prewrite_assertion_count	gauge
tidb_tikvclient_range_task_push_duration_bucket	histogram
tidb_tikvclient_range_task_stats	gauge
tidb_tikvclient_region_cache_operations_total	counter
tidb_tikvclient_region_err_total	counter
tidb_tikvclient_replica_selector_failure_counter	gauge
tidb_tikvclient_request_seconds_bucket	histogram
tidb_tikvclient_request_seconds_count	histogram
tidb_tikvclient_request_seconds_sum	histogram
tidb_tikvclient_request_time_counter	gauge
tidb_tikvclient_rpc_net_latency_seconds_bucket	histogram
tidb_tikvclient_rpc_net_latency_seconds_count	histogram
tidb_tikvclient_rpc_net_latency_seconds_sum	histogram
tidb_tikvclient_safets_update_counter	gauge
tidb_tikvclient_stale_read_bytes	gauge
tidb_tikvclient_stale_read_counter	gauge
tidb_tikvclient_stale_read_req_counter	gauge
tidb_tikvclient_store_slow_score	gauge
tidb_tikvclient_ts_future_wait_seconds_bucket	histogram
tidb_tikvclient_ts_future_wait_seconds_count	histogram
tidb_tikvclient_ts_future_wait_seconds_sum	histogram
tidb_tikvclient_ttl_lifetime_reach_total	counter
tidb_tikvclient_txn_cmd_duration_seconds_bucket	histogram
tidb_tikvclient_txn_cmd_duration_seconds_count	histogram
tidb_tikvclient_txn_commit_backoff_count_bucket	histogram
tidb_tikvclient_txn_commit_backoff_seconds_bucket	histogram
tidb_tikvclient_txn_heart_beat_bucket	histogram
tidb_tikvclient_txn_regions_num_bucket	histogram
tidb_tikvclient_txn_write_kv_num_bucket	histogram
tidb_tikvclient_txn_write_kv_num_sum	histogram
tidb_tikvclient_txn_write_size_bytes_bucket	histogram
tidb_tikvclient_txn_write_size_bytes_sum	histogram
tidb_topsql_ignored_total	counter
tidb_topsql_report_data_total_sum	gauge
tidb_topsql_report_duration_seconds_bucket	histogram
tidb_topsql_report_duration_seconds_count	histogram
tiflash_coprocessor_executor_count	gauge
tiflash_coprocessor_request_count	gauge
tiflash_coprocessor_request_duration_seconds_bucket	histogram
tiflash_coprocessor_request_duration_seconds_count	histogram
tiflash_coprocessor_request_duration_seconds_sum	histogram
tiflash_coprocessor_request_error	gauge
tiflash_coprocessor_request_handle_seconds_bucket	histogram
tiflash_coprocessor_request_handle_seconds_count	histogram
tiflash_coprocessor_request_handle_seconds_sum	histogram
tiflash_coprocessor_request_memory_usage_bucket	histogram
tiflash_coprocessor_response_bytes	gauge
tiflash_mpp_task_manager	gauge
tiflash_proxy_process_cpu_seconds_total	counter
tiflash_proxy_process_resident_memory_bytes	gauge
tiflash_raft_read_index_duration_seconds_bucket	histogram
tiflash_raft_read_index_duration_seconds_count	histogram
tiflash_raft_read_index_duration_seconds_sum	histogram
tiflash_raft_wait_index_duration_seconds_bucket	histogram
tiflash_raft_wait_index_duration_seconds_count	histogram
tiflash_raft_wait_index_duration_seconds_sum	histogram
tiflash_storage_throughput_bytes	gauge
tiflash_system_profile_event_PSMBackgroundReadBytes	gauge
tiflash_system_profile_event_PSMBackgroundWriteBytes	gauge
tiflash_system_profile_event_PSMReadBytes	gauge
tiflash_system_profile_event_PSMWriteBytes	gauge
tiflash_system_profile_event_RaftWaitIndexTimeout	gauge
tiflash_system_profile_event_ReadBufferAIOReadBytes	gauge
tiflash_system_profile_event_ReadBufferFromFileDescriptorReadBytes	gauge
tiflash_system_profile_event_WriteBufferAIOWriteBytes	gauge
tiflash_system_profile_event_WriteBufferFromFileDescriptorWriteBytes	gauge
tikv_backup_error_counter	gauge
tikv_backup_range_duration_seconds_bucket	histogram
tikv_backup_range_duration_seconds_count	histogram
tikv_backup_range_duration_seconds_sum	histogram
tikv_backup_range_size_bytes_bucket	histogram
tikv_backup_range_size_bytes_sum	histogram
tikv_backup_thread_pool_size	gauge
tikv_channel_full_total	counter
tikv_config_rocksdb	gauge
tikv_coprocessor_executor_count	gauge
tikv_coprocessor_request_duration_seconds_bucket	histogram
tikv_coprocessor_request_duration_seconds_count	histogram
tikv_coprocessor_request_duration_seconds_sum	histogram
tikv_engine_compaction_flow_bytes	gauge
tikv_engine_flow_bytes	gauge
tikv_engine_size_bytes	gauge
tikv_external_storage_create_seconds_bucket	histogram
tikv_grpc_msg_duration_seconds_bucket	histogram
tikv_grpc_msg_duration_seconds_count	histogram
tikv_grpc_msg_duration_seconds_sum	histogram
tikv_import_download_bytes_sum	gauge
tikv_import_download_duration_bucket	histogram
tikv_import_error_counter	gauge
tikv_import_ingest_byte	gauge
tikv_import_ingest_duration_bucket	histogram
tikv_import_range_delivery_duration_count	gauge
tikv_import_range_delivery_duration_sum	gauge
tikv_import_rpc_duration_bucket	histogram
tikv_import_rpc_duration_count	histogram
tikv_import_split_sst_duration_count	gauge
tikv_import_split_sst_duration_sum	gauge
tikv_import_sst_chunk_bytes_sum	gauge
tikv_import_sst_delivery_duration_count	gauge
tikv_import_sst_delivery_duration_sum	gauge
tikv_import_sst_ingest_duration_count	gauge
tikv_import_sst_ingest_duration_sum	gauge
tikv_import_sst_upload_duration_count	gauge
tikv_import_sst_upload_duration_sum	gauge
tikv_import_upload_chunk_bytes_sum	gauge
tikv_import_write_chunk_bytes_sum	gauge
tikv_raftstore_append_log_duration_seconds_bucket	histogram
tikv_raftstore_append_log_duration_seconds_count	histogram
tikv_raftstore_append_log_duration_seconds_sum	histogram
tikv_raftstore_apply_duration_secs_bucket	histogram
tikv_raftstore_apply_duration_secs_count	histogram
tikv_raftstore_apply_duration_secs_sum	histogram
tikv_raftstore_apply_log_duration_seconds_bucket	histogram
tikv_raftstore_apply_log_duration_seconds_count	histogram
tikv_raftstore_apply_log_duration_seconds_sum	histogram
tikv_raftstore_commit_log_duration_seconds_bucket	histogram
tikv_raftstore_commit_log_duration_seconds_count	histogram
tikv_raftstore_commit_log_duration_seconds_sum	histogram
tikv_raftstore_region_count	gauge
tikv_raftstore_store_duration_secs_bucket	histogram
tikv_raftstore_store_duration_secs_count	histogram
tikv_raftstore_store_duration_secs_sum	histogram
tikv_resource_control_background_quota_limiter	gauge
tikv_resource_control_background_resource_consumption	gauge
tikv_resource_control_background_task_wait_duration	gauge
tikv_resource_control_bg_resource_utilization	gauge
tikv_resource_control_priority_quota_limit	gauge
tikv_resource_control_priority_task_exec_duration	gauge
tikv_resource_control_priority_wait_duration_bucket	histogram
tikv_resource_control_priority_wait_duration_count	histogram
tikv_resource_control_priority_wait_duration_sum	histogram
tikv_resource_metering_report_data_count	gauge
tikv_resource_metering_report_duration_seconds_bucket	histogram
tikv_resource_metering_stat_task_count	gauge
tikv_scheduler_contex_total	counter
tikv_server_cpu_cores_quota	gauge
tikv_server_report_failure_msg_total	counter
tikv_storage_engine_async_request_duration_seconds_bucket	histogram
tikv_storage_engine_async_request_duration_seconds_count	histogram
tikv_storage_engine_async_request_duration_seconds_sum	histogram
tikv_thread_cpu_seconds_total	counter
up	gauge
