go_memstats_heap_inuse_bytes	gauge	Bytes in in-use memory spans from Go runtime
kv_engine_active_shards	gauge	Number of active shards in the engine
kv_engine_blob_tables_count	gauge	Number of blob tables in the engine
kv_engine_cache_miss	counter	Count of KV engine cache misses
kv_engine_cachefs_req_count	counter	Count of cache FS requests (hit/miss)
kv_engine_cf_level_num_files	gauge	Number of files in each column family level
kv_engine_cf_level_total_sizes_bytes	gauge	Total sizes of each column family level in bytes
kv_engine_compacting_shards	gauge	Number of shards currently being compacted
kv_engine_dfs_latency_seconds_bucket	histogram	Latency of DFS operations (S3/Azure) by API type
kv_engine_dfs_latency_seconds_count	histogram	Count of DFS operations
kv_engine_dfs_latency_seconds_sum	histogram	Total time of DFS operations
kv_engine_dfs_latency_with_retry_seconds_bucket	histogram	Latency of DFS operations including retry time
kv_engine_dfs_latency_with_retry_seconds_count	histogram	Count of DFS operations with retries
kv_engine_dfs_latency_with_retry_seconds_sum	histogram	Total time of DFS operations with retries
kv_engine_dfs_load_memory_usage_bytes	gauge	Memory usage for DFS loading operations
kv_engine_dfs_load_memory_wait_duration_seconds_bucket	histogram	Duration waiting to acquire DFS load memory
kv_engine_dfs_load_memory_wait_duration_seconds_count	histogram	Count of DFS memory wait operations
kv_engine_dfs_load_memory_wait_duration_seconds_sum	histogram	Total time waiting for DFS memory
kv_engine_dfs_request_counter	counter	Count of DFS requests by API type
kv_engine_dfs_retry_counter	counter	Count of DFS request retries
kv_engine_dfs_throughput_bytes	counter	Throughput bytes of DFS operations
kv_engine_entries	gauge	Total number of entries in the engine
kv_engine_filter_size_bytes	gauge	Total filter size in bytes
kv_engine_get_duration_seconds	histogram	Duration of KV engine get operations
kv_engine_get_duration_seconds_bucket	histogram	Bucketed histogram of get operation duration
kv_engine_get_duration_seconds_count	histogram	Count of get operations
kv_engine_has_del_prefixes_shards	gauge	Number of shards with delete prefixes
kv_engine_ia_main_queue_capacity	gauge	Capacity of IA (Ingest-Archive) main queue
kv_engine_ia_manager_segments_disk_size	gauge	Disk size of IA manager segments
kv_engine_ia_manager_segments_memory_size	gauge	Memory size of IA manager segments
kv_engine_ia_read_segment_cache_miss	counter	Count of IA segment read cache misses
kv_engine_ia_read_segment_duration_seconds_bucket	histogram	Duration of reading IA segments
kv_engine_ia_read_segment_duration_seconds_count	histogram	Count of IA segment reads
kv_engine_ia_read_segment_duration_seconds_sum	histogram	Total time reading IA segments
kv_engine_ia_small_queue_capacity	gauge	Capacity of IA small queue
kv_engine_in_use_blob_size_bytes	gauge	In-use blob size in bytes
kv_engine_index_size_bytes	gauge	Total index size in bytes
kv_engine_ingest_level_bucket	histogram	Histogram of levels where tables are ingested
kv_engine_ingest_level_count	histogram	Count of table ingestions by level
kv_engine_initial_flushed_shards	gauge	Number of initial flushed shards
kv_engine_inner_key_shards	gauge	Number of shards with inner keys
kv_engine_l0_tables_count	gauge	Number of L0 tables in the engine
kv_engine_l0_tables_size_bytes	gauge	Total size of L0 tables in bytes
kv_engine_level_write_bytes	counter	Write bytes of each level in KV engine
kv_engine_limiter_throttle_action_counter	counter	Count of throttling actions by limiter type
kv_engine_limiter_throttle_counter	counter	Count of throttle events by limiter
kv_engine_mem_size_bytes	gauge	Total KV size in bytes
kv_engine_mem_size_quota_bytes	gauge	Memory quota for KV engine memtables
kv_engine_mem_tables_count	gauge	Number of memory tables in the engine
kv_engine_old_entries	gauge	Number of old entries in the engine
kv_engine_partial_blob_count	gauge	Number of partial blob tables
kv_engine_partial_l0_count	gauge	Number of partial L0 tables
kv_engine_partial_ln_count	gauge	Number of partial Ln tables
kv_engine_pending_compaction_shards	gauge	Number of shards pending compaction
kv_engine_prepare_load_remote_file	counter	Count of remote files loaded during prepare
kv_engine_prepare_use_local_file	counter	Count of local file hits during prepare
kv_engine_ready_destroy_range_shards	gauge	Number of shards ready to destroy range
kv_engine_region_huge_l0_table_bytes_bucket	histogram	Histogram of huge L0 table bytes for regions
kv_engine_region_huge_l0_table_bytes_count	histogram	Count of huge L0 tables by region
kv_engine_region_huge_l0_table_bytes_sum	histogram	Total bytes of huge L0 tables
kv_engine_region_huge_mem_table_bytes_bucket	histogram	Histogram of huge memtable bytes for regions
kv_engine_region_huge_mem_table_bytes_count	histogram	Count of huge memtables by region
kv_engine_region_huge_mem_table_bytes_sum	histogram	Total bytes of huge memtables
kv_engine_seek_duration_seconds	histogram	Duration of KV engine seek operations
kv_engine_seek_duration_seconds_bucket	histogram	Bucketed histogram of seek duration
kv_engine_seek_duration_seconds_count	histogram	Count of seek operations
kv_engine_shards_total	gauge	Total number of shards in the engine
kv_engine_tombstones	gauge	Number of tombstones in the engine
kv_engine_total_blob_size_bytes	gauge	Total blob size in bytes
kv_engine_write_duration_seconds	histogram	Duration of KV engine write operations
kv_engine_write_duration_seconds_bucket	histogram	Bucketed histogram of write duration
kv_engine_write_duration_seconds_count	histogram	Count of write operations
kv_engine_write_flow_bucket	histogram	Bucketed histogram of write flow (keys/bytes)
kv_engine_write_flow_count	histogram	Count of write flow operations
kv_engine_write_flow_sum	histogram	Total write flow
kvengine_apply_change_set_total	counter	Total number of KV engine apply change set
native_br_backup_error	counter	Number of errors during native backup
native_br_backup_success	counter	Number of successful native backups
native_br_restore_error	counter	Number of errors during restoration
native_br_restore_rfengine_wal_epoch_overwritten_error	counter	Number of RF engine WAL epoch overwritten errors
native_br_restore_snapshot_request_secs_bucket	histogram	Duration of snapshot restore requests
native_br_restored_snapshot_bytes	counter	Total bytes of restored snapshots
node_cpu_seconds_total	counter	Total CPU seconds spent in each mode
node_disk_io_time_seconds_total	counter	Total seconds spent on disk I/O
node_disk_read_bytes_total	counter	Total bytes read from disk
node_disk_read_time_seconds_total	counter	Total time spent reading from disk
node_disk_reads_completed_total	counter	Number of completed disk read operations
node_disk_write_time_seconds_total	counter	Total time spent writing to disk
node_disk_writes_completed_total	counter	Number of completed disk write operations
node_disk_written_bytes_total	counter	Total bytes written to disk
pd_client_cmd_handle_cmds_duration_seconds_bucket	histogram	Duration of PD client command handling
pd_client_request_handle_requests_duration_seconds_bucket	histogram	Duration of PD client request handling
pd_schedule_operators_count	gauge	Count of PD schedule operators
pd_scheduler_store_status	gauge	Status of PD scheduler stores
process_cpu_seconds_total	counter	Total CPU seconds consumed by process
process_resident_memory_bytes	gauge	Resident memory size of the process
process_start_time_seconds	gauge	Start time of the process in seconds since epoch
raft_engine_apply_duration_seconds_bucket	histogram	Duration of Raft engine apply operations
raft_engine_backup_counter	counter	Count of Raft engine backups by status
raft_engine_backup_duration_seconds_bucket	histogram	Duration of Raft engine backup operations
raft_engine_compact_wal_duration_seconds_bucket	histogram	Duration of Raft engine WAL compaction
raft_engine_dfs_requests_total	counter	Total number of DFS requests from Raft engine
raft_engine_dfs_uploaded_bytes_total	counter	Total bytes uploaded to DFS by Raft engine
raft_engine_dfs_worker_healthy	gauge	Status of healthy DFS workers in Raft engine
raft_engine_fetch_entries_duration_seconds_bucket	histogram	Duration of fetching Raft entries
raft_engine_fetch_entries_duration_seconds_count	histogram	Count of Raft entry fetch operations
raft_engine_log_file_gc_size	histogram	Size of Raft log files during GC
raft_engine_memory_usage	gauge	Memory usage of Raft engine
raft_engine_pending_compaction_wals	gauge	Number of pending compaction WALs
raft_engine_persist_duration_seconds_bucket	histogram	Duration of Raft engine persist operations
raft_engine_persist_duration_seconds_count	histogram	Count of Raft persist operations
raft_engine_region_write_batch_size_bucket	histogram	Size of Raft engine region write batches
raft_engine_region_write_batch_size_count	histogram	Count of region write batches
raft_engine_region_write_batch_size_sum	histogram	Total size of region write batches
raft_engine_resouce_usage_bytes	gauge	Resource usage (memory/disk) of Raft engine
raft_engine_rotate_duration_seconds_bucket	histogram	Duration of Raft engine log rotation
raft_engine_take_snapshot_duration_seconds_bucket	histogram	Duration of taking Raft snapshots
raft_engine_total_entries_count	gauge	Total number of Raft entries (memory/offloaded)
raft_engine_total_wals_count	gauge	Total number of Raft WAL logs
raft_engine_truncate_duration_seconds_bucket	histogram	Duration of Raft engine truncate operations
raft_engine_wal_write_duration_seconds_bucket	histogram	Duration of Raft WAL write operations
raft_engine_wal_write_throttle_duration_seconds_bucket	histogram	Duration of Raft WAL write throttling
rfstore_local_file_alive	gauge	Number of alive local files
rfstore_local_file_error_total	counter	Total errors with local files
rfstore_local_file_gc_total	counter	Total local files garbage collected
rfstore_local_file_on_disk	gauge	Number of local files on disk
rfstore_local_file_pending_gc	gauge	Number of local files pending GC
rfstore_local_file_skip_gc	gauge	Number of local files skipped by GC
rfstore_raft_entry_fetches_task_duration_seconds_bucket	histogram	Duration of Raft entry fetch tasks
rfstore_raft_entry_fetches_task_duration_seconds_count	histogram	Count of Raft entry fetch tasks
rfstore_raft_entry_fetches_task_duration_seconds_sum	histogram	Total time of Raft entry fetch tasks
rfstore_raft_entry_fetches_total	counter	Total number of Raft entry fetches by type
tidb_log_backup_advancer_batch_size_bucket	histogram	Batch size of log backup advancer
tidb_log_backup_advancer_tick_duration_sec_bucket	histogram	Duration of log backup advancer tick
tidb_log_backup_advancer_tick_duration_sec_count	histogram	Count of log backup advancer ticks
tidb_log_backup_last_checkpoint	gauge	Last checkpoint timestamp of log backup
tidb_log_backup_region_request	gauge	Count of log backup region requests
tidb_log_backup_region_request_failure	gauge	Count of log backup region request failures
tidb_server_connections	gauge	Number of active client connections
tidb_server_get_token_duration_seconds_bucket	histogram	Duration of acquiring execution tokens
tidb_server_handle_query_duration_seconds_bucket	histogram	Duration of query handling
tidb_session_compile_duration_seconds_bucket	histogram	Duration of SQL compilation
tidb_session_parse_duration_seconds_bucket	histogram	Duration of SQL parsing
tidb_session_retry_num_bucket	histogram	Distribution of session retry counts
tidb_session_transaction_duration_seconds_bucket	histogram	Duration of transactions
tidb_session_transaction_statement_num_bucket	histogram	Number of statements per transaction
tidb_tikvclient_backoff_seconds_bucket	histogram	Duration of backoff on region errors
tidb_tikvclient_backoff_seconds_count	histogram	Count of backoff operations
tidb_tikvclient_gc_config	gauge	GC configuration values
tidb_tikvclient_gc_seconds_bucket	histogram	Duration of GC operations
tidb_tikvclient_gc_worker_actions_total	counter	Total count of GC worker actions
tidb_tikvclient_lock_resolver_actions_total	counter	Total count of lock resolver actions
tidb_tikvclient_range_task_stats	gauge	Statistics of range task execution
tidb_tikvclient_txn_cmd_duration_seconds_bucket	histogram	Duration of transaction commands
tikv_allocator_arena_count	gauge	Count of memory arenas by allocator
tikv_allocator_stats	gauge	Memory allocator statistics
tikv_allocator_thread_allocation	gauge	Thread allocation statistics
tikv_allocator_thread_stats	gauge	Per-thread allocator statistics
tikv_backup_error_counter	counter	Total number of backup errors
tikv_backup_range_duration_seconds_bucket	histogram	Duration of backup range operations
tikv_backup_range_duration_seconds_count	histogram	Count of backup range operations
tikv_backup_range_duration_seconds_sum	histogram	Total time of backup range operations
tikv_backup_range_size_bytes_bucket	histogram	Size of backed up data per range
tikv_backup_range_size_bytes_sum	histogram	Total bytes backed up
tikv_backup_raw_expired_count	counter	Count of raw KV expired during backup scan
tikv_backup_softlimit	gauge	Soft limit applied to backup thread pool
tikv_backup_thread_pool_size	gauge	Size of backup thread pool
tikv_batch_system_fsm_count_per_poll_bucket	histogram	Count of FSMs processed per poll
tikv_batch_system_fsm_poll_rounds_bucket	histogram	Poll rounds per FSM batch system poll
tikv_batch_system_fsm_poll_seconds_bucket	histogram	Duration of FSM batch system polls
tikv_batch_system_fsm_reschedule_total	counter	Total number of FSM reschedules
tikv_batch_system_fsm_schedule_wait_seconds_bucket	histogram	Duration of FSM schedule waits
tikv_broadcast_normal_duration_seconds_bucket	histogram	Duration of broadcast normal messages
tikv_causal_ts_provider_get_ts_duration_seconds_bucket	histogram	Duration of getting causal timestamps
tikv_causal_ts_provider_get_ts_duration_seconds_count	histogram	Count of causal timestamp requests
tikv_causal_ts_provider_tso_batch_list_counting_bucket	histogram	Count of TSO batch list operations
tikv_causal_ts_provider_tso_batch_list_counting_count	histogram	Count of TSO batches
tikv_causal_ts_provider_tso_batch_renew_duration_seconds_bucket	histogram	Duration of TSO batch renewal
tikv_causal_ts_provider_tso_batch_renew_duration_seconds_count	histogram	Count of TSO batch renewals
tikv_causal_ts_provider_tso_batch_size	gauge	Size of TSO batches
tikv_channel_full_total	counter	Total count of channel full events
tikv_check_leader_request_item_count_bucket	histogram	Number of region info in check leader requests
tikv_check_leader_request_size_bytes_bucket	histogram	Size of check leader requests
tikv_cloud_request_duration_seconds_count	histogram	Count of cloud storage request durations
tikv_coprocessor_dag_request_count	counter	Total number of DAG coprocessor requests
tikv_coprocessor_executor_count	counter	Count of coprocessor executor invocations
tikv_coprocessor_mem_lock_check_duration_seconds_bucket	histogram	Duration of memory lock checking
tikv_coprocessor_mem_lock_check_duration_seconds_count	histogram	Count of memory lock checks
tikv_coprocessor_mem_lock_check_duration_seconds_sum	histogram	Total time of memory lock checks
tikv_coprocessor_memory_quota	gauge	Memory quota for coprocessor
tikv_coprocessor_request_duration_seconds_bucket	histogram	Duration of coprocessor requests
tikv_coprocessor_request_duration_seconds_count	histogram	Count of coprocessor requests
tikv_coprocessor_request_duration_seconds_sum	histogram	Total time of coprocessor requests
tikv_coprocessor_request_error	counter	Total number of coprocessor request errors
tikv_coprocessor_request_handle_seconds_bucket	histogram	Duration of handling coprocessor requests
tikv_coprocessor_request_handle_seconds_count	histogram	Count of handled coprocessor requests
tikv_coprocessor_request_handle_seconds_sum	histogram	Total time handling coprocessor requests
tikv_coprocessor_request_wait_seconds_bucket	histogram	Wait time for coprocessor requests
tikv_coprocessor_request_wait_seconds_count	histogram	Count of coprocessor request waits
tikv_coprocessor_request_wait_seconds_sum	histogram	Total wait time for coprocessor requests
tikv_coprocessor_response_bytes	counter	Total bytes of coprocessor responses
tikv_coprocessor_rocksdb_perf	counter	Count of RocksDB performance metrics
tikv_coprocessor_scan_details	counter	Scan details for coprocessor operations
tikv_coprocessor_scan_keys_bucket	histogram	Number of keys scanned per request
tikv_coprocessor_scan_keys_count	histogram	Count of scan key operations
tikv_coprocessor_scan_keys_sum	histogram	Total keys scanned
tikv_critical_error_total	counter	Total number of critical errors
tikv_encryption_data_key_storage_total	gauge	Total number of encryption data keys in use
tikv_encryption_file_num	gauge	Number of files being encrypted
tikv_encryption_is_initialized	gauge	Flag indicating if encryption is initialized
tikv_encryption_meta_file_size_bytes	gauge	Size of encryption meta files
tikv_encryption_write_read_file_duration_seconds_bucket	histogram	Duration of encrypted file operations
tikv_encryption_write_read_file_duration_seconds_count	histogram	Count of encrypted file operations
tikv_encryption_write_read_file_duration_seconds_sum	histogram	Total time of encrypted file operations
tikv_engine_block_cache_size_bytes	gauge	Size of block cache in bytes
tikv_engine_bloom_efficiency	counter	Bloom filter efficiency metrics
tikv_engine_bytes_per_write	gauge	Bytes written per write operation
tikv_engine_cache_efficiency	counter	Cache efficiency metrics
tikv_engine_compaction_flow_bytes	counter	Bytes read/written during compaction
tikv_engine_flow_bytes	counter	Engine I/O flow bytes
tikv_engine_get_micro_seconds	gauge	Duration of get operations in microseconds
tikv_engine_get_served	counter	Count of get operations served
tikv_engine_locate	counter	Count of key locate operations
tikv_engine_memtable_efficiency	counter	Memtable efficiency metrics
tikv_engine_num_files_at_level	gauge	Number of files at each level
tikv_engine_num_immutable_mem_table	gauge	Number of immutable memtables
tikv_engine_pending_compaction_bytes	gauge	Bytes pending compaction
tikv_engine_seek_micro_seconds	gauge	Duration of seek operations in microseconds
tikv_engine_size_bytes	gauge	Size of storage engine
tikv_engine_sst_read_micros	gauge	Duration of SST file reads in microseconds
tikv_engine_wal_file_sync_micro_seconds	gauge	Duration of WAL file sync in microseconds
tikv_engine_wal_file_synced	counter	Count of WAL file syncs
tikv_engine_write_micro_seconds	gauge	Duration of write operations in microseconds
tikv_engine_write_stall	gauge	Write stall duration
tikv_external_storage_create_seconds_bucket	histogram	Duration of creating external storage
tikv_external_storage_create_seconds_count	histogram	Count of external storage creations
tikv_external_storage_create_seconds_sum	histogram	Total time creating external storage
tikv_futurepool_handled_task_total	counter	Total number of handled tasks in future pool
tikv_futurepool_pending_task_total	gauge	Number of pending tasks in future pool
tikv_gc_compaction_failure	counter	Count of GC compaction failures
tikv_gc_compaction_filter_mvcc_deletion_handled	counter	MVCC deletions handled by GC filter
tikv_gc_compaction_filter_mvcc_deletion_met	counter	MVCC deletions met by GC filter
tikv_gc_compaction_filter_mvcc_deletion_wasted	counter	Wasted MVCC deletions in GC filter
tikv_gc_compaction_filter_orphan_versions	counter	Orphan versions found by GC filter
tikv_gc_compaction_filter_perform	counter	Count of GC compaction filter executions
tikv_gc_compaction_filter_skip	counter	Count of skipped GC compaction filters
tikv_gc_compaction_filtered	counter	Count of entries filtered by GC
tikv_gc_compaction_mvcc_rollback	counter	Count of MVCC rollbacks by GC
tikv_gc_worker_too_busy	counter	Count of GC worker being too busy
tikv_gcworker_autogc_processed_regions	gauge	Number of regions processed by auto GC
tikv_gcworker_autogc_safe_point	gauge	Safe point used for auto GC
tikv_gcworker_gc_keys	counter	Keys affected during GC
tikv_gcworker_gc_task_duration_vec_bucket	histogram	Duration of GC task execution
tikv_gcworker_gc_task_duration_vec_count	histogram	Count of GC tasks
tikv_gcworker_gc_task_duration_vec_sum	histogram	Total time of GC tasks
tikv_gcworker_gc_task_fail_vec	counter	Count of failed GC tasks
tikv_gcworker_gc_tasks_vec	counter	Count of GC tasks processed
tikv_grpc_msg_duration_seconds_bucket	histogram	Duration of gRPC message handling
tikv_grpc_msg_duration_seconds_count	histogram	Count of gRPC messages
tikv_grpc_msg_duration_seconds_sum	histogram	Total time of gRPC message handling
tikv_grpc_msg_fail_total	counter	Total number of failed gRPC messages
tikv_grpc_request_source_counter_vec	counter	Count of RPC requests by source
tikv_grpc_request_source_duration_vec	counter	Duration of RPC requests by source
tikv_grpc_resource_group_total	counter	Total requests by resource group
tikv_import_applier_event	counter	Count of import applier events
tikv_import_apply_bytes_bucket	histogram	Bytes applied during import
tikv_import_apply_bytes_sum	histogram	Total bytes applied during import
tikv_import_apply_cache_event	counter	Count of import apply cache events
tikv_import_apply_cached_bytes	gauge	Cached bytes during import apply
tikv_import_apply_duration_bucket	histogram	Duration of import apply operations
tikv_import_download_bytes_bucket	histogram	Bytes downloaded during import
tikv_import_download_bytes_sum	histogram	Total bytes downloaded during import
tikv_import_download_duration_bucket	histogram	Duration of import download operations
tikv_import_engine_request_bucket	histogram	Duration of import engine requests
tikv_import_error_counter	counter	Total number of import errors
tikv_import_ingest_byte_bucket	histogram	Bytes ingested during import
tikv_import_ingest_duration_bucket	histogram	Duration of import ingest operations
tikv_import_local_write_bytes	counter	Bytes written from local backend
tikv_import_local_write_keys	counter	Keys written from local backend
tikv_import_rpc_count	gauge	Count of import RPC requests
tikv_import_rpc_duration_bucket	histogram	Duration of import RPC calls
tikv_import_rpc_duration_count	histogram	Count of import RPC calls
tikv_import_rpc_duration_sum	histogram	Total time of import RPC calls
tikv_in_memory_engine_cache_count	gauge	Count of cache entries in in-memory engine
tikv_in_memory_engine_eviction_duration_secs_bucket	histogram	Duration of in-memory engine evictions
tikv_in_memory_engine_eviction_duration_secs_count	histogram	Count of in-memory engine evictions
tikv_in_memory_engine_flow	counter	Flow count of in-memory engine operations
tikv_in_memory_engine_gc_duration_secs_bucket	histogram	Duration of in-memory engine GC
tikv_in_memory_engine_gc_filtered	counter	Entries filtered by in-memory engine GC
tikv_in_memory_engine_kv_operations	counter	KV operations in in-memory engine
tikv_in_memory_engine_load_duration_secs_bucket	histogram	Duration of in-memory engine loading
tikv_in_memory_engine_load_duration_secs_count	histogram	Count of in-memory engine loads
tikv_in_memory_engine_locate	counter	Key locate operations in in-memory engine
tikv_in_memory_engine_memory_usage_bytes	gauge	Memory usage of in-memory engine
tikv_in_memory_engine_newest_safe_point	gauge	Newest safe point in in-memory engine
tikv_in_memory_engine_oldest_safe_point	gauge	Oldest safe point in in-memory engine
tikv_in_memory_engine_prepare_for_write_duration_seconds_bucket	histogram	Duration of write preparation
tikv_in_memory_engine_prepare_for_write_duration_seconds_count	histogram	Count of write preparations
tikv_in_memory_engine_prepare_for_write_duration_seconds_sum	histogram	Total time of write preparations
tikv_in_memory_engine_seek_duration_bucket	histogram	Duration of seek operations
tikv_in_memory_engine_seek_duration_count	histogram	Count of seek operations
tikv_in_memory_engine_seek_duration_sum	histogram	Total time of seek operations
tikv_in_memory_engine_snapshot_acquire_failed_reason_count	counter	Count of snapshot acquire failures
tikv_in_memory_engine_write_duration_seconds_bucket	histogram	Duration of write operations
tikv_in_memory_engine_write_duration_seconds_count	histogram	Count of write operations
tikv_in_memory_engine_write_duration_seconds_sum	histogram	Total time of write operations
tikv_in_memory_pessimistic_locking	counter	Count of in-memory pessimistic locking
tikv_io_bytes	counter	Total I/O bytes
tikv_load_base_split_duration_seconds_bucket	histogram	Duration of load-based split
tikv_load_base_split_duration_seconds_count	histogram	Count of load-based splits
tikv_load_base_split_duration_seconds_sum	histogram	Total time of load-based splits
tikv_load_base_split_event	counter	Count of load-based split events
tikv_lock_manager_detect_duration_bucket	histogram	Duration of lock detection
tikv_lock_manager_detect_duration_count	histogram	Count of lock detections
tikv_lock_manager_detect_duration_sum	histogram	Total time of lock detection
tikv_lock_manager_detector_leader_heartbeat	gauge	Status of lock detector leader heartbeat
tikv_lock_manager_error_counter	counter	Total number of lock manager errors
tikv_lock_manager_task_counter	counter	Total number of lock manager tasks
tikv_lock_manager_wait_table_status	gauge	Status of lock wait table
tikv_lock_manager_waiter_lifetime_duration_bucket	histogram	Duration of lock waiter lifetime
tikv_lock_manager_waiter_lifetime_duration_count	histogram	Count of lock waiters
tikv_lock_manager_waiter_lifetime_duration_sum	histogram	Total lifetime of lock waiters
tikv_lock_wait_queue_entries_gauge_vec	gauge	Entries in lock wait queue
tikv_lock_wait_queue_length_bucket	histogram	Length of lock wait queues
tikv_log_backup_enabled	counter	Flag indicating log backup is enabled
tikv_log_backup_errors	counter	Total number of log backup errors
tikv_log_backup_event_handle_duration_sec_bucket	histogram	Duration of log backup event handling
tikv_log_backup_fatal_errors	counter	Total number of fatal log backup errors
tikv_log_backup_flush_duration_sec_bucket	histogram	Duration of log backup flush
tikv_log_backup_flush_duration_sec_count	histogram	Count of log backup flushes
tikv_log_backup_flush_file_size_count	histogram	Count of flushed files
tikv_log_backup_flush_file_size_sum	histogram	Total size of flushed files
tikv_log_backup_handle_kv_batch_bucket	histogram	Size of KV batches in log backup
tikv_log_backup_handle_kv_batch_sum	histogram	Total KV batches handled
tikv_log_backup_heap_memory	gauge	Heap memory used by log backup
tikv_log_backup_incremental_scan_bytes_sum	histogram	Bytes scanned in incremental backup
tikv_log_backup_initial_scan_duration_sec_bucket	histogram	Duration of initial scan
tikv_log_backup_initial_scan_operations	counter	Count of initial scan operations
tikv_log_backup_initial_scan_reason	counter	Reason count for initial scans
tikv_log_backup_internal_actor_acting_duration_sec_bucket	histogram	Duration of internal actor actions
tikv_log_backup_internal_actor_acting_duration_sec_count	histogram	Count of internal actor actions
tikv_log_backup_metadata_key_operation	gauge	Count of metadata key operations
tikv_log_backup_observed_region	gauge	Number of observed regions
tikv_log_backup_on_event_duration_seconds_bucket	histogram	Duration of log backup event processing
tikv_log_backup_pending_initial_scan	gauge	Count of pending initial scans
tikv_log_backup_task_status	gauge	Status of log backup tasks
tikv_multilevel_level0_chance	gauge	Chance of level 0 in multilevel compaction
tikv_multilevel_level_elapsed	counter	Time elapsed at each level
tikv_non_txn_command_throttle_time_total	counter	Total throttle time for non-txn commands
tikv_pd_heartbeat_message_total	counter	Total number of PD heartbeat messages
tikv_pd_pending_heartbeat_total	gauge	Number of pending region heartbeats
tikv_pd_pending_tso_request_total	gauge	Number of pending TSO requests
tikv_pd_reconnect_total	counter	Total number of PD reconnections
tikv_pd_request_duration_seconds_count	histogram	Count of PD request durations
tikv_pd_request_duration_seconds_sum	histogram	Total time of PD requests
tikv_pd_request_forwarded	gauge	Status of forwarded PD requests
tikv_pd_validate_peer_total	counter	Total number of peer validations
tikv_pessimistic_lock_memory_size	gauge	Memory size of pessimistic locks
tikv_raft_apply_ahead_of_persist_bucket	histogram	Lag between apply and persist
tikv_raft_enable_unpersisted_apply_regions	gauge	Count of regions with unpersisted apply
tikv_raft_entries_evict_bytes	counter	Bytes evicted from Raft entry cache
tikv_raftstore_admin_cmd_total	counter	Total number of admin commands
tikv_raftstore_append_log_duration_seconds_bucket	histogram	Duration of appending Raft logs
tikv_raftstore_append_log_duration_seconds_count	histogram	Count of Raft log appends
tikv_raftstore_append_log_duration_seconds_sum	histogram	Total time appending Raft logs
tikv_raftstore_apply_duration_secs_bucket	histogram	Duration of applying Raft entries
tikv_raftstore_apply_duration_secs_count	histogram	Count of Raft apply operations
tikv_raftstore_apply_duration_secs_sum	histogram	Total time applying Raft entries
tikv_raftstore_apply_key_size_bucket	histogram	Size of keys being applied
tikv_raftstore_apply_log_duration_seconds_bucket	histogram	Duration of applying logs
tikv_raftstore_apply_log_duration_seconds_count	histogram	Count of log applications
tikv_raftstore_apply_log_duration_seconds_sum	histogram	Total time applying logs
tikv_raftstore_apply_msg_len_bucket	histogram	Length of apply messages
tikv_raftstore_apply_perf_context_time_duration_secs_bucket	histogram	Perf context duration for apply
tikv_raftstore_apply_proposal_bucket	histogram	Duration of apply proposals
tikv_raftstore_apply_value_size_bucket	histogram	Size of values being applied
tikv_raftstore_apply_wait_time_duration_secs_bucket	histogram	Wait time for apply tasks
tikv_raftstore_apply_wait_time_duration_secs_count	histogram	Count of apply waits
tikv_raftstore_apply_wait_time_duration_secs_sum	histogram	Total apply wait time
tikv_raftstore_check_split_duration_seconds_bucket	histogram	Duration of split checking
tikv_raftstore_check_split_total	counter	Total number of split checks
tikv_raftstore_check_stale_peer	counter	Count of stale peer checks
tikv_raftstore_clean_region_count	counter	Count of cleaned regions
tikv_raftstore_clear_overlap_region_duration_seconds_bucket	histogram	Duration of clearing overlap regions
tikv_raftstore_clear_overlap_region_duration_seconds_count	histogram	Count of overlap region clears
tikv_raftstore_clear_overlap_region_duration_seconds_sum	histogram	Total time clearing overlap regions
tikv_raftstore_commit_log_duration_seconds_bucket	histogram	Duration of committing Raft logs
tikv_raftstore_commit_log_duration_seconds_count	histogram	Count of Raft log commits
tikv_raftstore_commit_log_duration_seconds_sum	histogram	Total time committing Raft logs
tikv_raftstore_event_duration_bucket	histogram	Duration of Raftstore events
tikv_raftstore_hibernated_peer_state	gauge	Number of peers in hibernated state
tikv_raftstore_inspect_duration_seconds_bucket	histogram	Duration of Raftstore inspections
tikv_raftstore_io_reschedule_pending_tasks_total	gauge	Pending tasks from IO rescheduling
tikv_raftstore_io_reschedule_region_total	gauge	Number of IO rescheduled regions
tikv_raftstore_leader_missing	gauge	Number of leader missing regions
tikv_raftstore_local_read_executed_requests	counter	Number of local read requests executed
tikv_raftstore_local_read_executed_stale_read_requests	counter	Number of stale read requests executed
tikv_raftstore_local_read_reject_total	counter	Total number of rejected local reads
tikv_raftstore_log_lag_sum	histogram	Log lag in regions
tikv_raftstore_peer_in_flashback_state	gauge	Number of peers in flashback state
tikv_raftstore_peer_msg_len_bucket	histogram	Length of peer messages
tikv_raftstore_process_busy	gauge	Busyness of Raftstore process
tikv_raftstore_proposal_total	counter	Total number of proposals
tikv_raftstore_propose_log_size_sum	histogram	Total size of proposed logs
tikv_raftstore_raft_dropped_message_total	counter	Total number of dropped Raft messages
tikv_raftstore_raft_log_gc_failed	counter	Count of failed Raft log GC
tikv_raftstore_raft_log_gc_seek_operations_count	counter	Count of Raft log GC seek operations
tikv_raftstore_raft_log_gc_skipped	counter	Count of skipped Raft log GC
tikv_raftstore_raft_log_gc_write_duration_secs_bucket	histogram	Duration of Raft log GC writes
tikv_raftstore_raft_log_gc_write_duration_secs_count	histogram	Count of Raft log GC writes
tikv_raftstore_raft_log_gc_write_duration_secs_sum	histogram	Total time of Raft log GC writes
tikv_raftstore_raft_log_kv_sync_duration_secs_bucket	histogram	Duration of Raft log KV sync
tikv_raftstore_raft_log_kv_sync_duration_secs_count	histogram	Count of Raft log KV syncs
tikv_raftstore_raft_log_kv_sync_duration_secs_sum	histogram	Total time of Raft log KV sync
tikv_raftstore_raft_process_duration_secs_bucket	histogram	Duration of Raft process
tikv_raftstore_raft_process_duration_secs_count	histogram	Count of Raft processes
tikv_raftstore_raft_process_duration_secs_sum	histogram	Total time of Raft process
tikv_raftstore_raft_ready_handled_total	counter	Total number of Raft ready handled
tikv_raftstore_raft_sent_message_total	counter	Total number of Raft messages sent
tikv_raftstore_region_count	gauge	Number of regions in Raftstore
tikv_raftstore_region_size_bucket	histogram	Size of regions
tikv_raftstore_region_size_count	histogram	Count of region size measurements
tikv_raftstore_region_size_sum	histogram	Total size of regions
tikv_raftstore_request_wait_time_duration_secs_bucket	histogram	Wait time for requests
tikv_raftstore_request_wait_time_duration_secs_count	histogram	Count of request waits
tikv_raftstore_request_wait_time_duration_secs_sum	histogram	Total request wait time
tikv_raftstore_slow_score	gauge	Slow score of the store
tikv_raftstore_slow_trend	gauge	Slow trend indicator
tikv_raftstore_slow_trend_l0	gauge	Slow trend for L0
tikv_raftstore_slow_trend_result	gauge	Result of slow trend calculation
tikv_raftstore_slow_trend_result_value	gauge	Value of slow trend result
tikv_raftstore_snapshot_apply_wait_duration_seconds_bucket	histogram	Wait time for snapshot apply
tikv_raftstore_snapshot_duration_seconds_bucket	histogram	Duration of snapshot operations
tikv_raftstore_snapshot_generation_wait_duration_seconds_bucket	histogram	Wait time for snapshot generation
tikv_raftstore_snapshot_pending_applies	gauge	Number of pending snapshot applies
tikv_raftstore_snapshot_total	counter	Total number of snapshots
tikv_raftstore_snapshot_traffic_total	gauge	Total snapshot traffic
tikv_raftstore_store_duration_secs_bucket	histogram	Duration of Raft store operations
tikv_raftstore_store_duration_secs_count	histogram	Count of Raft store operations
tikv_raftstore_store_duration_secs_sum	histogram	Total time of Raft store operations
tikv_raftstore_store_perf_context_time_duration_secs_bucket	histogram	Perf context duration for store
tikv_raftstore_store_wf_batch_wait_duration_seconds_bucket	histogram	Wait duration for batch in store
tikv_raftstore_store_wf_batch_wait_duration_seconds_count	histogram	Count of batch waits
tikv_raftstore_store_wf_batch_wait_duration_seconds_sum	histogram	Total batch wait time
tikv_raftstore_store_wf_before_write_duration_seconds_bucket	histogram	Duration before write in waterfall
tikv_raftstore_store_wf_before_write_duration_seconds_count	histogram	Count of before write
tikv_raftstore_store_wf_before_write_duration_seconds_sum	histogram	Total time before write
tikv_raftstore_store_wf_commit_log_duration_seconds_bucket	histogram	Duration of commit log in waterfall
tikv_raftstore_store_wf_commit_log_duration_seconds_count	histogram	Count of commit log
tikv_raftstore_store_wf_commit_log_duration_seconds_sum	histogram	Total commit log time
tikv_raftstore_store_wf_commit_not_persist_log_duration_seconds_bucket	histogram	Duration of commit not persist
tikv_raftstore_store_wf_commit_not_persist_log_duration_seconds_count	histogram	Count of commit not persist
tikv_raftstore_store_wf_commit_not_persist_log_duration_seconds_sum	histogram	Total commit not persist time
tikv_raftstore_store_wf_persist_duration_seconds_bucket	histogram	Duration of persist in waterfall
tikv_raftstore_store_wf_persist_duration_seconds_count	histogram	Count of persist
tikv_raftstore_store_wf_persist_duration_seconds_sum	histogram	Total persist time
tikv_raftstore_store_wf_send_proposal_duration_seconds_bucket	histogram	Duration of send proposal
tikv_raftstore_store_wf_send_proposal_duration_seconds_count	histogram	Count of send proposal
tikv_raftstore_store_wf_send_proposal_duration_seconds_sum	histogram	Total send proposal time
tikv_raftstore_store_wf_send_to_queue_duration_seconds_bucket	histogram	Duration of send to queue
tikv_raftstore_store_wf_send_to_queue_duration_seconds_count	histogram	Count of send to queue
tikv_raftstore_store_wf_send_to_queue_duration_seconds_sum	histogram	Total send to queue time
tikv_raftstore_store_wf_write_end_duration_seconds_bucket	histogram	Duration of write end
tikv_raftstore_store_wf_write_end_duration_seconds_count	histogram	Count of write end
tikv_raftstore_store_wf_write_end_duration_seconds_sum	histogram	Total write end time
tikv_raftstore_store_wf_write_kvdb_end_duration_seconds_bucket	histogram	Duration of KVDB write end
tikv_raftstore_store_wf_write_kvdb_end_duration_seconds_count	histogram	Count of KVDB write end
tikv_raftstore_store_wf_write_kvdb_end_duration_seconds_sum	histogram	Total KVDB write end time
tikv_raftstore_store_write_handle_msg_duration_secs_bucket	histogram	Duration of handle msg in write
tikv_raftstore_store_write_msg_block_wait_duration_seconds_bucket	histogram	Duration of msg block wait
tikv_raftstore_store_write_msg_block_wait_duration_seconds_count	histogram	Count of msg block waits
tikv_raftstore_store_write_raftdb_duration_seconds_bucket	histogram	Duration of RaftDB writes
tikv_raftstore_store_write_raftdb_duration_seconds_count	histogram	Count of RaftDB writes
tikv_raftstore_store_write_raftdb_duration_seconds_sum	histogram	Total RaftDB write time
tikv_raftstore_store_write_send_duration_seconds_bucket	histogram	Duration of write send
tikv_raftstore_store_write_send_duration_seconds_count	histogram	Count of write sends
tikv_raftstore_store_write_send_duration_seconds_sum	histogram	Total write send time
tikv_raftstore_store_write_task_wait_duration_secs_bucket	histogram	Duration of task wait in write
tikv_raftstore_store_write_task_wait_duration_secs_count	histogram	Count of task waits
tikv_raftstore_store_write_task_wait_duration_secs_sum	histogram	Total task wait time
tikv_raftstore_store_write_trigger_wb_bytes_bucket	histogram	Size of write batch triggered
tikv_raftstore_write_cmd_total	counter	Total number of write commands
tikv_rate_limiter_max_bytes_per_sec	gauge	Max bytes per second for rate limiter
tikv_rate_limiter_request_wait_duration_seconds_bucket	histogram	Wait duration for rate limiter
tikv_rate_limiter_request_wait_duration_seconds_count	histogram	Count of rate limiter waits
tikv_rate_limiter_request_wait_duration_seconds_sum	histogram	Total rate limiter wait time
tikv_region_written_bytes_bucket	histogram	Bytes written per region
tikv_region_written_bytes_count	histogram	Count of region writes
tikv_region_written_bytes_sum	histogram	Total bytes written to regions
tikv_region_written_keys_bucket	histogram	Keys written per region
tikv_region_written_keys_count	histogram	Count of key writes
tikv_region_written_keys_sum	histogram	Total keys written to regions
tikv_replica_read_lock_check_duration_seconds_bucket	histogram	Duration of replica read lock check
tikv_resolved_ts_channel_penging_cmd_bytes_total	counter	Bytes of pending commands in channel
tikv_resolved_ts_check_leader_duration_seconds_bucket	histogram	Duration of check leader
tikv_resolved_ts_fail_advance_count	counter	Count of failed resolved-ts advances
tikv_resolved_ts_initial_scan_backoff_duration_seconds_bucket	histogram	Duration of initial scan backoff
tikv_resolved_ts_lock_heap_bytes	gauge	Bytes in lock heap
tikv_resolved_ts_min_follower_safe_ts_gap_millis	gauge	Gap between now and min follower safe ts
tikv_resolved_ts_min_follower_safe_ts_region	gauge	Region with min follower safe ts
tikv_resolved_ts_min_leader_resolved_ts_gap_millis	gauge	Gap between now and min leader resolved ts
tikv_resolved_ts_min_leader_resolved_ts_region	gauge	Region with min leader resolved ts
tikv_resolved_ts_min_resolved_ts_gap_millis	gauge	Gap between now and min resolved ts
tikv_resolved_ts_min_resolved_ts_region	gauge	Region with min resolved ts
tikv_resolved_ts_region_resolve_status	gauge	Status of resolved-ts regions
tikv_resource_control_background_task_wait_duration	counter	Duration of background task wait
tikv_resource_control_priority_quota_limit	gauge	Priority quota limit
tikv_rocksdb_damaged_files	gauge	Number of damaged RocksDB files
tikv_rocksdb_damaged_files_deleted	counter	Count of deleted damaged files
tikv_safe_point_gap_with_in_memory_engine	gauge	Gap between safe point and in-memory engine
tikv_scheduler_command_duration_seconds_bucket	histogram	Duration of scheduler commands
tikv_scheduler_command_duration_seconds_count	histogram	Count of scheduler commands
tikv_scheduler_command_duration_seconds_sum	histogram	Total time of scheduler commands
tikv_scheduler_commands_pri_total	counter	Total count of commands by priority
tikv_scheduler_contex_total	gauge	Number of pending commands in scheduler
tikv_scheduler_kv_command_key_read_bucket	histogram	Keys read by KV commands
tikv_scheduler_kv_command_key_read_count	histogram	Count of key reads
tikv_scheduler_kv_command_key_read_sum	histogram	Total keys read
tikv_scheduler_kv_command_key_write_bucket	histogram	Keys written by KV commands
tikv_scheduler_kv_command_key_write_count	histogram	Count of key writes
tikv_scheduler_kv_command_key_write_sum	histogram	Total keys written
tikv_scheduler_kv_scan_details	counter	Scan details for KV commands
tikv_scheduler_latch_wait_duration_seconds_bucket	histogram	Duration of latch wait
tikv_scheduler_latch_wait_duration_seconds_count	histogram	Count of latch waits
tikv_scheduler_latch_wait_duration_seconds_sum	histogram	Total latch wait time
tikv_scheduler_memory_quota_size	gauge	Memory quota size for scheduler
tikv_scheduler_processing_read_duration_seconds_bucket	histogram	Duration of read processing
tikv_scheduler_processing_read_duration_seconds_count	histogram	Count of read processing
tikv_scheduler_processing_read_duration_seconds_sum	histogram	Total read processing time
tikv_scheduler_running_commands	gauge	Number of running commands
tikv_scheduler_stage_total	counter	Total count of commands by stage
tikv_scheduler_throttle_duration_seconds_bucket	histogram	Duration of scheduler throttle
tikv_scheduler_throttle_flow	gauge	Throttled flow at scheduler level
tikv_scheduler_too_busy_total	counter	Total count of scheduler too busy
tikv_scheduler_wait_for_process_duration_seconds_bucket	histogram	Wait time for process
tikv_scheduler_write_flow	gauge	Write flow at scheduler level
tikv_scheduler_writing_bytes	gauge	Bytes being written
tikv_server_address_resolve_duration_secs_bucket	histogram	Duration of address resolution
tikv_server_cpu_cores_quota	gauge	Total CPU cores quota for TiKV
tikv_server_grpc_req_batch_size_bucket	histogram	Size of gRPC request batches
tikv_server_grpc_req_batch_size_count	histogram	Count of request batches
tikv_server_grpc_req_batch_size_sum	histogram	Total size of request batches
tikv_server_grpc_resp_batch_size_bucket	histogram	Size of gRPC response batches
tikv_server_grpc_resp_batch_size_count	histogram	Count of response batches
tikv_server_grpc_resp_batch_size_sum	histogram	Total size of response batches
tikv_server_mem_trace_sum	gauge	Sum of memory trace for TiKV
tikv_server_memory_quota_bytes	gauge	Memory quota for TiKV server
tikv_server_raft_append_rejects	counter	Count of rejected Raft append messages
tikv_server_raft_client_wait_ready_duration_bucket	histogram	Duration waiting for raft client ready
tikv_server_raft_client_wait_ready_duration_count	histogram	Count of wait ready
tikv_server_raft_client_wait_ready_duration_sum	histogram	Total wait ready time
tikv_server_raft_message_batch_size_bucket	histogram	Size of Raft message batches
tikv_server_raft_message_batch_size_count	histogram	Count of Raft message batches
tikv_server_raft_message_batch_size_sum	histogram	Total Raft message batch size
tikv_server_raft_message_duration_seconds_bucket	histogram	Duration of Raft messages
tikv_server_raft_message_duration_seconds_count	histogram	Count of Raft messages
tikv_server_raft_message_duration_seconds_sum	histogram	Total Raft message time
tikv_server_raft_message_flush_total	counter	Total number of flushed Raft messages
tikv_server_raft_message_recv_total	counter	Total number of received Raft messages
tikv_server_report_failure_msg_total	counter	Total number of failure report messages
tikv_server_request_batch_size_bucket	histogram	Size of request batches
tikv_server_request_batch_size_count	histogram	Count of request batches
tikv_server_request_batch_size_sum	histogram	Total request batch size
tikv_server_send_snapshot_duration_seconds_bucket	histogram	Duration of sending snapshots
tikv_server_snapshot_task_total	counter	Total number of snapshot tasks
tikv_snapshot_kv_count_bucket	histogram	Number of KV pairs in snapshots
tikv_snapshot_limit_generate_bytes	counter	Bytes generated for snapshots
tikv_snapshot_limit_transport_bytes	counter	Bytes transported for snapshots
tikv_snapshot_size_bucket	histogram	Size of snapshots
tikv_snapshot_type_count	counter	Count of snapshots by type
tikv_status_server_request_duration_seconds_bucket	histogram	Duration of status server requests
tikv_status_server_request_duration_seconds_count	histogram	Count of status server requests
tikv_status_server_request_duration_seconds_sum	histogram	Total status server request time
tikv_storage_check_mem_lock_duration_seconds_bucket	histogram	Duration of memory lock check
tikv_storage_command_total	counter	Total number of storage commands
tikv_storage_engine_async_request_duration_seconds_bucket	histogram	Duration of async storage requests
tikv_storage_engine_async_request_duration_seconds_count	histogram	Count of async storage requests
tikv_storage_engine_async_request_duration_seconds_sum	histogram	Total async storage request time
tikv_storage_engine_async_request_total	counter	Total number of async storage requests
tikv_storage_full_compact_duration_seconds_bucket	histogram	Duration of full compaction
tikv_storage_full_compact_duration_seconds_count	histogram	Count of full compactions
tikv_storage_full_compact_duration_seconds_sum	histogram	Total full compaction time
tikv_storage_full_compact_increment_duration_seconds_bucket	histogram	Duration of compaction increment
tikv_storage_full_compact_increment_duration_seconds_count	histogram	Count of compaction increments
tikv_storage_full_compact_increment_duration_seconds_sum	histogram	Total compaction increment time
tikv_storage_full_compact_pause_duration_seconds_bucket	histogram	Duration of compaction pause
tikv_storage_full_compact_pause_duration_seconds_count	histogram	Count of compaction pauses
tikv_storage_full_compact_pause_duration_seconds_sum	histogram	Total compaction pause time
tikv_storage_gc_skipped_counter	counter	Count of skipped GC commands
tikv_storage_mvcc_gc_delete_versions_sum	histogram	Total versions deleted by MVCC GC
tikv_storage_mvcc_scan_lock_read_duration_seconds_bucket	histogram	Duration of MVCC lock scan
tikv_storage_mvcc_scan_lock_read_duration_seconds_count	histogram	Count of MVCC lock scans
tikv_storage_mvcc_scan_lock_read_duration_seconds_sum	histogram	Total MVCC lock scan time
tikv_storage_process_stat_cpu_usage	gauge	CPU usage of storage process
tikv_storage_rocksdb_perf	counter	Count of RocksDB performance metrics
tikv_store_size_bytes	gauge	Size of storage
tikv_thread_cpu_seconds_total	gauge	CPU seconds consumed by threads
tikv_thread_nonvoluntary_context_switches	gauge	Non-voluntary context switches by thread
tikv_thread_voluntary_context_switches	gauge	Voluntary context switches by thread
tikv_threads_io_bytes_total	gauge	Total I/O bytes by thread
tikv_threads_state	gauge	State of threads
tikv_ttl_checker_actions	counter	Actions of TTL checker
tikv_ttl_checker_compact_duration_bucket	histogram	Duration of TTL compact
tikv_ttl_checker_compact_duration_count	histogram	Count of TTL compacts
tikv_ttl_checker_compact_duration_sum	histogram	Total TTL compact time
tikv_ttl_checker_poll_interval	gauge	Poll interval of TTL checker
tikv_ttl_checker_processed_regions	gauge	Regions processed by TTL checker
tikv_ttl_expire_kv_count_total	counter	Total KV expired by TTL
tikv_ttl_expire_kv_size_total	counter	Total KV size expired by TTL
tikv_txn_command_throttle_time_total	counter	Total throttle time for txn commands
tikv_unified_read_pool_running_tasks	gauge	Running tasks in unified read pool
tikv_worker_handled_task_total	counter	Total tasks handled by workers
tikv_worker_limiter_request_wait_duration_seconds_bucket	histogram	Duration of limiter wait
tikv_worker_limiter_waiting_requests_counter	gauge	Waiting requests in limiter
tikv_worker_native_br_counter	counter	Count of native BR operations
tikv_worker_native_br_duration_seconds_bucket	histogram	Duration of native BR operations
tikv_worker_pending_task_total	gauge	Number of pending tasks
tikv_worker_remote_analyze_request_counter	counter	Count of remote analyze requests
tikv_worker_remote_analyze_response_size	counter	Size of remote analyze responses
tikv_worker_remote_checksum_request_counter	counter	Count of remote checksum requests
tikv_worker_remote_checksum_response_size	counter	Size of remote checksum responses
tikv_worker_remote_compact_failed_requests_counter	counter	Count of failed remote compact requests
tikv_worker_remote_compact_processing_requests_counter	gauge	Processing remote compact requests
tikv_worker_remote_compact_request_duration_seconds_bucket	histogram	Duration of remote compact requests
tikv_worker_remote_compact_request_duration_seconds_count	histogram	Count of remote compact requests
tikv_worker_remote_compact_request_duration_seconds_sum	histogram	Total remote compact request time
tikv_worker_remote_cop_dag_request_counter	counter	Count of remote cop DAG requests
tikv_worker_remote_cop_dag_response_size	counter	Size of remote cop DAG responses
tikv_worker_remote_cop_failed_requests_counter	counter	Count of failed remote cop requests
tikv_worker_remote_cop_processing_requests_counter	gauge	Processing remote cop requests
tikv_worker_remote_cop_request_duration_seconds_bucket	histogram	Duration of remote cop requests
tikv_worker_remote_cop_request_duration_seconds_count	histogram	Count of remote cop requests
tikv_worker_remote_cop_request_duration_seconds_sum	histogram	Total remote cop request time
tikv_worker_remote_cop_snapshot_duration_seconds_bucket	histogram	Duration of remote cop snapshot
tikv_worker_remote_cop_snapshot_duration_seconds_count	histogram	Count of remote cop snapshots
tikv_worker_remote_cop_snapshot_duration_seconds_sum	histogram	Total remote cop snapshot time
tikv_yatp_pool_schedule_wait_duration_bucket	histogram	Duration of YATP pool schedule wait
tikv_yatp_pool_schedule_wait_duration_count	histogram	Count of YATP pool schedule waits
tikv_yatp_pool_schedule_wait_duration_sum	histogram	Total YATP pool schedule wait time
tikv_yatp_task_exec_duration_bucket	histogram	Duration of YATP task execution
tikv_yatp_task_exec_duration_count	histogram	Count of YATP task executions
tikv_yatp_task_exec_duration_sum	histogram	Total YATP task execution time
tikv_yatp_task_execute_times_bucket	histogram	Times of YATP task execution
tikv_yatp_task_execute_times_count	histogram	Count of YATP task executions
tikv_yatp_task_execute_times_sum	histogram	Total YATP task execution times
tikv_yatp_task_poll_duration_bucket	histogram	Duration of YATP task poll
tikv_yatp_task_poll_duration_count	histogram	Count of YATP task polls
tikv_yatp_task_poll_duration_sum	histogram	Total YATP task poll time
